Repository;App;Source;Commits;StartTimestamp;EndTimestamp;TimestampDifference;TsDiffInWeeks
zappalex/Swiper;zappalex.swiper;G;6;1457466591;1462456032;4989441;82.497.371.031.746
TedHoryczun/One-Rep-Max-Calculator;com.repmax.devlanding.onerepmaxcalculator;G;6;1475882455;1481039746;5157291;852.726.686.507.937
darshanrn/SpyCam;googleplay.hidecam&amp;G;6;1456243283;1461561093;5317810;879.267.526.455.027
yivanus/ingress-GlyphAutoHacker;com.cygery.repetitouch.free&amp;G;6;1431573570;1437030279;5456709;902.233.630.952.381
feminefa/femis-open-player;orimi.com.femi;G;6;1423404655;1429218404;5813749;961.268.022.486.773
gpiskas/Crydev.net_Reader;geo.piskas.crydev;G;6;1377594841;1383501833;5906992;976.685.185.185.185
abhinavdua/VIT-Faculty-Databse;com.abhinav.facultydatabasedev;G;6;1438364578;1444519643;6155065;10.177.025.462.963
usbong/usbong_ping_pong;usbong.android.ping_pong&amp;G;6;1482401977;1488629945;6227968;102.975.661.375.661
Ashishkapil/MDU;mduashisharchit.org.mdu&amp;G;6;1455528883;1462112066;6583183;10.884.892.526.455
tunaemre/BPM-Touch-Android;com.tunaemre.bpmcounter;G;6;1486118998;1492761440;6642442;109.828.736.772.487
Anuj20/CrossRoads;com.AndroidTechies.gamer.randomexcessvariable&amp;G;6;1485442835;1492623082;7180247;11.872.101.521.164
muba1ham/ProfileApplication;application.profile.software.hamza.com.hamzaprofileapplication;G;6;1465767814;1473526827;7759013;128.290.558.862.434
benoitdeguine/BiffyClyroTour;biffyclyro.com.tour;G;6;1471351660;1479596416;8244756;136.322.023.809.524
lolevsky/GCM_Chat_example;com.iapplize.gcmtest;G;6;1373063623;1382043196;8979573;148.471.775.793.651
atindersaini/SVS-app;com.app.svs&amp;G;6;1448300612;1457428612;9128000;150.925.925.925.926
mh0rst/skycast;de.sky.bw;G;6;1418340542;1428535619;10195077;16.856.939.484.127
sachinmuralig/power-menu;me.sachinmuralig.powermenu;G;6;1467654836;1478373633;10718797;177.228.786.375.661
rishabhdugar/simcardinfo;com.simcard.siminfo;G;6;1454857822;1466047320;11189498;185.011.541.005.291
thegreatshasha/OpenCV_Java_AndroidStudio;com.shashwat.opencv_java_androidstudio;G;6;1474868889;1486369320;11500431;190.152.628.968.254
MohammedRashad/NASA-Space-Apps-Ismailia;challenge.nasa.com.nasasapceappschallenge;G;6;1473724077;1486167810;12443733;205.749.553.571.429
ggpasqualino/menu-uem;br.org.pasqualino.menuuem;G;6;1419252239;1431878332;12626093;20.876.476.521.164
SimonMcDonnell/Noted;com.simonmcdonnell.noted;G;6;1473423308;1486166097;12742789;210.694.262.566.138
VNAPNIC/WeatherMaterial;vnapnic.project.WeatherMaterial;G;6;1443464442;1456670902;13206460;21.836.078.042.328
oel/sweetspots;com.genuine.android.sweetspots;G;6;1450314939;1463617848;13302909;219.955.505.952.381
vyaban/Stormify;vik.linx.stormify;G;6;1403226111;1416691967;13465856;222.649.735.449.735
prasanthlouis/Cgpa-Calculator;com.psiuol21.cgpa;G;6;1423072200;1436803061;13730861;227.031.431.878.307
oxplot/bradybound;com.oxplot.bradybound;G;6;1407609723;1421363526;13753803;227.410.763.888.889
roczei/smartbox;hu.roczei.smartbox;G;6;1425824179;1439652457;13828278;228.642.162.698.413
faezmurshidi/Botmage-Google-Vision-Image-Detection-Android-;com.faezmurshidiadnan.whatisthisimage;G;6;1471096349;1485313037;14216688;235.064.285.714.286
JonKussmann/SimpleMath-app;com.jonkussmann.simplemath&amp;G;6;1402957569;1417585015;14627446;241.855.919.312.169
jsfrost/StreetlightSeattleReporter;org.codeforseattle.streetlightseattlereporter;G;6;1389242155;1403998976;14756821;243.995.056.216.931
D4ddy-LiLd4rk/MaterialMenuDrawer;com.brobox.materialmenudrawer;G;6;1415639622;1430985421;15345799;253.733.449.074.074
andreimpircalaboiu/around;com.ampapps.around;G;6;1475227090;1490883361;15656271;25.886.691.468.254
MostafaGazar/Widgets;com.meg7.freshpaper;G;6;1405172356;1421004312;15831956;261.771.759.259.259
sassa400/mathdokuext;com.klokisoft.mathdokuext&amp;G;6;1443796441;1459709572;15913131;263.113.938.492.064
vladimirVoytash/DailySongs;com.headlezz.dailymusic;G;6;1471193215;1487779957;16586742;274.251.686.507.937
ftena/Triforce3d;com.tarlic.triforce3d;G;6;1422795007;1439589889;16794882;277.693.154.761.905
andi4work/TwitterAuth;www.maximoapps.in.twitterlocation&amp;G;6;1474470126;1491816301;17346175;286.808.449.074.074
pedja1/srbodroid;com.srbodroid.app;G;6;1428169256;1445683632;17514376;28.958.955.026.455
hackjutsu/Owls_Eye;com.owlscoffeehouse.ocrize;G;6;1426888088;1444721859;17833771;294.870.552.248.677
rabyunghwa/Alexandria;com.awesome.byunghwa.app.alexandria;G;6;1441348346;1459266753;17918407;296.269.957.010.582
guysagy/gamersweb-android;com.guysagy.gamersweb;G;6;1472879698;1491889869;19010171;314.321.610.449.735
InstituteOfErgonomics/AndroidOcclusion;de.tum.mw.lfe.occlusion;G;6;1427136686;1446237726;19101040;315.824.074.074.074
calimoto-GmbH/mapsforge-calimoto-Version;com.calimoto.calimoto;G;6;1464602272;1485200100;20597828;340.572.552.910.053
marcosdiez/IngressIntelToGps;com.marcosdiez.ingressurltogps;G;6;1385304996;1406221981;20916985;345.849.619.708.995
cypressious/KitMensaAndroid;com.cypressworks.mensaplan;G;6;1443453349;1464633509;21180160;350.201.058.201.058
frankkienl/BronyMLPBlindBagGuide;nl.frankkie.bronymlpblindbagguide;G;6;1421589260;1443077015;21487755;355.286.954.365.079
JorgeAntonio512/InteractiveStory;com.georgepazdral.interactivestory;G;6;1431558554;1453171833;21613279;357.362.417.328.042
Remian8985/Cryptify-encryption-app;com.tasdeeq.cryptify;G;6;1414807377;1436433740;21626363;357.578.753.306.878
kevinfaust0308/Pommy;com.kevin.pomodoro;G;6;1471834194;1493762485;21928291;362.570.949.074.074
theoldreader/newsplus;com.noinnion.android.newsplus;G;6;1398272362;1421265573;22993211;380.178.753.306.878
MathiasSeguy-Android2EE/SignInWithGoogleTutorial;com.android2ee.project.gplus.signin.publicid&amp;G;6;1371312639;1396255561;24942922;412.416.038.359.788
OrOz77/Posture_Reminder;com.or_oz.posture&amp;G;6;1436478531;1461691656;25213125;416.883.680.555.556
lantian699/Velib-Lite;com.ciel.equipe;G;6;1435178684;1461678440;26499756;438.157.341.269.841
Maeja/slonovoz;bigi.slonovoz;G;6;1465230207;1492779739;27549532;455.514.748.677.249
sefagurel/LastEarthquakes;com.sefagurel.lastearthquakes;G;6;1432048549;1460046521;27997972;462.929.431.216.931
Vloz/Unecm_Android;fr.bobenrieth.unecm;G;6;1444922324;1473264122;28341798;468.614.384.920.635
mzamani1/RandomizedWorkout;com.zamani.randomizedworkout&amp;G;6;1375032918;1404958685;29925767;494.804.348.544.974
ltqthang/Sim-services;siminfo.alpha.com.siminfo;G;6;1429446762;1460972964;31526202;521.266.567.460.317
calinwolf08/SpeedCuber;com.calinwashington.android&amp;G;6;1439170790;1470882210;31711420;524.329.034.391.534
sameer2800/Aparoksha15-App;com.aparoksha.main&amp;G;6;1444496592;1477150715;32654123;53.991.605.489.418
ThimoKl/CheapestGas;de.einfachtanken;G;6;1430155671;1463742036;33586365;555.330.109.126.984
igorcrevar/Outgoing-Calls-Viewer;com.rogicrew.callstats;G;6;1379356740;1413395619;34038879;562.812.152.777.778
domiflichi/Garage-Door-Controller-Client-Android;com.domiflichi.garagedoorcontroller;G;6;1352654841;1388425914;35771073;591.452.926.587.302
Gnzlt/BV-SSPApp;com.gnzlt.bv_sspapp;G;6;1406929495;1443356185;36426690;602.293.154.761.905
alrokayan/Fix-Arabic-Messages-From-Andriod-To-iOS;com.alrokayan.fix.arabic.iPhoneUTF8;G;6;1344153063;1381245868;37092805;613.306.960.978.836
CalSPEED/CalSPEED-Android;gov.ca.cpuc.calspeed.android&amp;G;6;1367271455;1404364577;37093122;613.312.202.380.952
gudomau/iDOIT;br.com.milond.idoit.idoittodolist;G;6;1432861039;1470192401;37331362;617.251.355.820.106
f2prateek/shush-wifi;com.publicobject.shush;G;6;1398813457;1441502540;42689083;705.838.012.566.138
southerton81/housemaker;com.kurovsky.houseoftheday;G;6;1400834107;1445243801;44409694;734.287.268.518.518
lucamtudor/lantern;com.tudorluca.lantern;G;6;1410956751;1455918186;44961435;743.409.970.238.095
AkhilNadendla/Spot-the-Dot;com.mygdx.game.spotthedot&amp;G;6;1428174550;1475198029;47023479;777.504.613.095.238
DMLoy/WhoYouKnowApp;com.you.know&amp;G;6;1386623925;1435247155;48623230;803.955.522.486.772
Raag079/namma-mysuru;com.project.raghavendra.nammamysore;G;6;1435365057;1484072485;48707428;805.347.685.185.185
coinsecure/Coinsecure-Bitcoin-Prices-App;com.pricetable.coinsecure;G;6;1398505509;1451407343;52901834;874.699.636.243.386
mcandre/hello-android;us.yellosoft.helloandroid;G;6;1354908108;1410024919;55116811;911.322.933.201.058
shubham-aher/GajStotra;shubham.aher.gajstotra;G;6;1368521482;1425323914;56802432;939.193.650.793.651
adiga/JustBlink;com.adiga.justblink;G;6;1428468428;1485318245;56849817;939.977.132.936.508
vishnus/Olam;com.olam;G;6;1378641865;1441465035;62823170;103.874.289.021.164
lamaken/fairsplit;visualk.apps.fairsplit;G;6;1410638914;1476374780;65735866;10.869.025.462.963
costular/crabox;com.costular.crabox.android&amp;G;6;1402069085;1473592769;71523684;11.826.005.952.381
coolshou/search-light;com.scottmain.android.searchlight;G;6;1357875924;1441030454;83154530;137.490.955.687.831
synaptik-/SoundWave;com.synaptik.soundwave;G;6;1402481431;1489452667;86971236;143.801.646.825.397
jpuderer/Tutorials;ca.littlebox.misc.vcat;F;6;1287601655;1384992683;97391028;161.030.138.888.889
mkttanabe/WakeOnLanGCM;jp.klab.wakeonlangcm;G;6;1369287480;1487108669;117821189;194.810.166.997.354
dondido/buddyracer;com.publicgamelibrary.buddyracer;G;7;1399100617;1404033333;4932716;815.594.576.719.577
BORSHEVIK/ThreeDTouchMasterLib;com.aleksandr.miron;G;7;1465657861;1470642176;4984315;824.126.157.407.407
stefannew/OpenBook;com.stefannew.openbook;G;7;1417062596;1422050752;4988156;824.761.243.386.243
joeatx247/IOIO-Rover;app.akexorcist.ioiocamerarobot&amp;G;7;1439015333;1444075471;5060138;836.663.029.100.529
furu8ma/WifiToggler;jp.hateblo.furu8ma.wifitoggler;G;7;1460334037;1465800494;5466457;903.845.403.439.153
intrications/browser-intercept;com.intrications.android.sharebrowser;G;7;1361713916;1367841955;6128039;101.323.396.164.021
alidabour/StockHawk-master;com.ali.stockhawk;G;7;1474106882;1480578576;6471694;107.005.522.486.772
rubdottocom/afr-sender;com.basetis.blinkingread.blinkingread;G;7;1394538739;1401463858;6925119;114.502.628.968.254
ramosisw/Macondo;mx.itson.macondo;G;7;1430825207;1437798571;6973364;115.300.330.687.831
guiguito/SlidesCast;com.ggt.slidescast;G;7;1410698651;1419246428;8547777;141.332.291.666.667
tyashin/wifiwhitelist;com.timtory.wifiapwhitelistpersonal;G;7;1399318495;1408022739;8704244;143.919.378.306.878
pghant/NotificationSaver;com.pghant.notifsaver;G;7;1412459802;1421463486;9003684;148.870.436.507.937
qn5566/RDCar_Sample;com.weichieh.rdcar;G;7;1439788190;1448962101;9173911;151.685.036.375.661
dmitriy-deomin/HelpNumber;dmitriy.deomin.helpnumber_free;G;7;1481440139;1491409875;9969736;164.843.518.518.519
JohanCosemans/YourHomeApp;net.yourhomeapp.plus;G;7;1473693299;1483996836;10303537;17.036.271.494.709
NeogoMan/Simple-Todo-List;list.ado.to.simple.simpletodolist&amp;G;7;1471299432;1481657804;10358372;171.269.378.306.878
sjs/artpacks_cordova;org.artpacks;G;7;1421856023;1434051624;12195601;201.646.841.931.217
FakeHeal/MladMerindzhey;com.phakeapps.mladmerindzhey.app;G;7;1405103944;1418828344;13724400;226.924.603.174.603
YMLabs/stormplayer;com.ymlabs.stormplayer;G;7;1406656759;1420731215;14074456;232.712.566.137.566
joan-domingo/Sports-GPS-Tracker;cat.xojan.sporttracker;G;7;1406812559;1421660639;14848080;245.503.968.253.968
AlexKorovyansky/WearPomodoro;com.alexkorovyansky.wearpomodoro;G;7;1411144298;1428510495;17366197;287.139.500.661.376
dinamansour83/igoHangoutsAndroid;com.dinamansour.igo;G;7;1431600816;1450566964;18966148;313.593.716.931.217
tritiumminus/android-wifi-key-view;wkv.android.evait.com.wifikeyview;G;7;1467825229;1488140482;20315253;335.900.347.222.222
dac101/AndriodAppJamspeak;catchmedia.jam.speak&amp;G;7;1419313801;1439927956;20614155;340.842.509.920.635
MohammadAdib/LOIC;genius.mohammad.loic;G;7;1365991360;1386831553;20840193;344.579.910.714.286
aleksz/auto-bluetooth;com.gmail.at.zhuikov.aleksandr.ab;G;7;1336411500;1357940749;21529249;355.973.032.407.407
EasyReimbursement/ReembolsoFacilFree;br.com.reembolsofacil.free&amp;G;7;1416855253;1442423447;25568194;42.275.453.042.328
mikeshz/Yes-Mom;com.yesmom.yesmom;G;7;1448857568;1475197047;26339479;435.507.258.597.884
maikenunes/MControl;net.maikenunes.mcontrol&amp;G;7;1436378645;1464564561;28185916;466.036.970.899.471
lucasmlima08/Forkan_Android;com.myllenno.lucas.forkanedu;G;7;1432410557;1461014169;28603612;47.294.332.010.582
ac-pm/SSLUnpinning_Cydia;com.saurik.substrate;G;7;1425947339;1454808574;28861235;477.202.959.656.085
CS-Labs/Bill-Splitter;com.cslabs.billsplitter&amp;G;7;1435016419;1464643073;29626654;489.858.697.089.947
cuongutd/GoogleSpreadSheet;com.tb2g.spreadsheet;G;7;1449790848;1481045718;31254870;516.780.257.936.508
Aixoniarutad/NarcoticsAnonymous;ciceroapps.tether.na;G;7;1450227479;1484687650;34460171;569.777.959.656.085
whrobbins/Final-Grade-Calculator;com.robbinsdev.finalgradecalculator&amp;G;7;1387919786;1424995635;37075849;613.026.603.835.979
sinpolib/nfcspy;com.sinpo.nfcspy;G;7;1392989173;1438519412;45530239;752.814.798.280.423
Pulimet/LearnNotes;net.alexandroid.music.learnnotes;G;7;1429376003;1477498060;48122057;795.668.931.878.307
nakous/playlistHtml5Audio;com.cxxxxx;G;7;1442156288;1490958847;48802559;806.920.618.386.243
aterribili/MontaMega;br.com.android.mmega;G;7;1384376260;1433201891;48825631;807.302.099.867.725
mcandre/hello-phonegap;us.yellosoft.hellophonegap;G;7;1355030306;1410025283;54994977;909.308.482.142.857
Inoculates/Circle-Game;memori.circle&amp;G;7;1410353544;1472566223;62212679;102.864.879.298.942
marc97/InstitutMarina;cat.institutmarina.insmarina;G;7;1367171848;1435848086;68676238;113.551.980.820.106
yoggy/ColorPickerCamera;net.sabamiso.colorpickercamera;G;7;1383911281;1466483386;82572105;136.527.951.388.889
JohnHBrock/soniferous;brock.soniferous;G;7;1355450578;1446622475;91171897;150.747.184.193.122
mekya/simple-android-instant-messaging-application;com.butterfly;G;7;1242840788;1462527004;219686216;363.237.791.005.291
stefanLeo/FHTW_App;fhtw.lvplan&amp;G;8;1366130364;1371478241;5347877;884.238.921.957.672
agapoff/azimuth-runner;name.agapoff.oresund;G;8;1470919581;1476285375;5365794;887.201.388.888.889
Twilight-Hacker/StockXchange2;com.galadar.example.stockxchange;G;8;1452367323;1458163808;5796485;958.413.525.132.275
YA-androidapp/Shiobe3;jp.gr.java_conf.ya.shiobeforandroid3;G;8;1457178167;1463284520;6106353;100.964.831.349.206
abodehq/Huson-Almuslim-Android-v2;com.isslam.husonmuslim;G;8;1423038843;1429213109;6174266;102.087.731.481.481
marc-li/TweetBot;com.lid.marcl.gotweetbot&amp;G;8;1483671854;1489964591;6292737;104.046.577.380.952
naman14/PlayNewsStandDemo;com.naman14.newsstand;G;8;1419624588;1426082421;6457833;106.776.339.285.714
ChristopherTulip/MapHomeTest;com.tulip.taxiguestimator&amp;G;8;1358837349;1366276218;7438869;122.997.172.619.048
wolfgang-s/owncloud-gallery;md.steuer.mobile.owncloud_gallery.free;G;8;1405499018;1412941264;7442246;123.053.009.259.259
lucasmlima08/TwoChoicesEightQueens_Android;com.uepb.ia.rainhas;G;8;1431900678;1439893848;7993170;132.162.202.380.952
gvozditskiy/water_meter;com.gvozditskiy.watermeter;G;8;1482522367;1490605209;8082842;133.644.874.338.624
KrzysiekT/Tatry-na-zywo;com.tarnawski.tatry;G;8;1429476652;1437897537;8420885;139.234.209.656.085
just-4-fun/Po.Grom;cyua.android.client;G;8;1394581377;1403374467;8793090;145.388.392.857.143
GwenIves/TravelItch;com.foundry.app.stockton.travelitchlite;G;8;1412275672;1421764634;9488962;156.894.212.962.963
akihumi/Niri;jp.ac.itc.s11013.niri;G;8;1352480466;1362541934;10061468;166.360.251.322.751
Kimita/Gcal_Importer;net.crappo.android.androics;G;8;1398053739;1409017658;10963919;181.281.729.497.355
mstrey/seashell;br.nom.strey.maicon.seashell;G;8;1365518028;1377106760;11588732;191.612.632.275.132
salendron/pingeb.org-Finder-Android;org.pingeb.finder;G;8;1360520018;1372355221;11835203;195.687.880.291.005
jalmeidaa/Kairos---An-Android-App;com.jalmeida;G;8;1464074777;1476780231;12705454;210.076.951.058.201
dubyajaysmith/Taxi;com.appsforchange.taxi&amp;G;8;1369600650;1383215783;13615133;225.117.939.814.815
MagikLab/my-own-playstore;vn.magik.labstore;G;8;1479260426;1493092541;13832115;22.870.560.515.873
SeanCherngTW/CIN-NoBile;com.cin.linyuehlii.nobile&amp;G;8;1467098824;1481186742;14087918;232.935.152.116.402
nraboy/android-spyfi-app;com.nraboy.spyfi;G;8;1378316051;1393297974;14981923;247.716.980.820.106
cheinr/crisp-cut;com.chein.crispcut2.android;G;8;1457763719;1474506954;16743235;276.839.203.042.328
NyiNyiLin/Secret-Keyboard;com.nyi.secret.secretkeyboard&amp;G;8;1456112959;1472972058;16859099;278.754.943.783.069
sarettasarda/GarageRadio;com.saracraba.garageradio;G;8;1399517829;1416515164;16997335;281.040.591.931.217
RxMz/DynPin;com.todaysfuture.dynpin;G;8;1454926158;1472127338;17201180;284.411.044.973.545
Eyesonly88/Auckland-Parking;com.molabs.aucklandparking;G;8;1332142291;1351350126;19207835;317.589.864.417.989
ajscape/PixaToon;com.ajscape.pixatoon;G;8;1452103928;1472236994;20133066;332.887.996.031.746
jgilje/pideo;net.jgilje.pideo;G;8;1455824712;1477857590;22032878;364.300.231.481.481
basarbk/MenuExtensionApp;com.bafoly.sample.menuextensionapp;G;8;1444506068;1467389957;22883889;378.371.180.555.556
DaviddeMiguel/meslize-fotomaton;com.meslize.fotomaton&amp;G;8;1405938348;1429326520;23388172;386.709.193.121.693
ZorgeR/Noizer;com.zlab.noizer.app;F;8;1469557392;1493554315;23996923;396.774.520.502.645
cnevinc/icareyou;com.icareyou.food;G;8;1386697454;1411189917;24492463;404.967.972.883.598
JoosepHint/eKool;com.JHapps.eKool;G;8;1381922639;1406744284;24821645;410.410.796.957.672
nizhogor/AlarmClock;com.nizhogor.flashalarm;G;8;1459916915;1485155293;25238378;417.301.223.544.974
tijee/dnd4android;com.thomasgallinari.dndcharactersheet;G;8;1358179869;1384164442;25984573;429.639.103.835.979
dreamingbinary/AutoPlay;org.twinone.autoplay;G;8;1397424317;1425147318;27723001;458.382.953.042.328
lyandrew/interview-app;com.SoftwareInterview;G;8;1458965768;1486797952;27832184;460.188.227.513.228
phabvionics/pilot-altimeter;uk.co.phabvionics.pilotaltimeter&amp;G;8;1431276523;1460579785;29303262;484.511.607.142.857
TimMackenzie/VoiceNote;com.simplifynowsoftware.voicenote;G;8;1435359689;1467816762;32457073;536.657.953.042.328
marcyliao/Tab-The-Tile;com.marcyliao.game.tabthetile;G;8;1410841326;1443369365;32528039;537.831.332.671.958
gshimansky/MosHelperUnroot;ru.mos.helper;G;8;1458409048;1491419085;33010037;545.800.876.322.751
m4rk3t/PluginInstaller;com.m4rk3t.libcopy2&amp;G;8;1427458759;1462810089;35351330;584.512.731.481.481
SavandBros/TiwunAndroidApp;com.tiwun.tiwunandroidapp;G;8;1379928595;1415410101;35481506;586.665.112.433.862
d-kunin/Verbie;by.kunin.android.langrescue;G;8;1315128949;1351536761;36407812;601.981.018.518.519
AlphawolfWMP/SeriesGuideExtStreamingSearch;de.schloebe.seriesguide.streamingfinder.app;G;8;1445631111;1482774749;37143638;614.147.453.703.704
GautamGupta/Q.-Flashlight;com.qandro.flashlight;G;8;1341339866;1388405221;47065355;778.197.007.275.132
cmrigney/piprojects;com.rigney.raspberrypiprojects;G;8;1369687278;1416921958;47234680;780.996.693.121.693
pmachapman/nzwalks-android;nz.co.conglomo.nzwalks;G;8;1426212491;1474456172;48243681;797.679.910.714.286
ftena/HyperionGame;com.tarlic.hyperiongame;G;8;1381245966;1430725067;49479101;818.106.828.703.704
sakisakira/Peintureroid;jp.sakira.peintureroid&amp;G;8;1323873517;1374074230;50200713;830.038.244.047.619
willerce/WhatsInput;com.buscode.whatsinput;G;8;1394093840;1453793135;59699295;987.091.517.857.143
d4rken/android-fms;eu.thedarken.fms;G;8;1427128760;1486983095;59854335;989.655.009.920.635
kennydude/UrlOpener;me.kennydude.dev.urlopener;F;8;1300026109;1362600709;62574600;103.463.293.650.794
JonnoFTW/SMS-Morse;com.jonathanmackenzie.sms_morse;G;8;1416296886;1481599041;65302155;107.973.139.880.952
dillbyrne/Bodha-Converter;byrne.utilities.converter;G;8;1394141949;1460227823;66085874;109.268.971.560.847
igorcrevar/RollOverSphere---a-simple-libgdx-game;com.wayilookatgames.rolloverball;G;8;1334177508;1413399353;79221845;130.988.500.330.688
andviane/prism;org.us.andriod;G;8;1403374062;1486847813;83473751;138.018.768.187.831
h44z/Sprinternet-Device-Manager;at.sprinternet.odm;G;8;1393848283;1493581150;99732867;16.490.222.718.254
erik-ropez/sleep-check-reminder;com.ropez.android.sleepcheckreminder;G;8;1332358771;1450130203;117771432;194.727.896.825.397
lnanek/GreenerGasPedal;name.nanek.greenerpedal;G;9;1341010252;1347500522;6490270;107.312.665.343.915
sjp4/CanvasNowPlaying;com.pennas.pebblecanvas;G;9;1373480818;1380048434;6567616;108.591.534.391.534
uwatm8/BorderRisk;com.sonsofhesslow.games.risk;G;9;1464770131;1471556925;6786794;112.215.509.259.259
sahaab/SimpleGlowLWP;com.sahaab.glow;G;9;1408311570;1415111620;6800050;112.434.689.153.439
heysadboy/Pick-Flick;sadboy.pickflick;G;9;1477236404;1484419814;7183410;118.773.313.492.063
kconger/org.thcongers.mcluster;org.thecongers.mcluster;G;9;1435200255;1442444983;7244728;119.787.169.312.169
justinmwarner/GestureTutorial;com.gesturetutorialsample.awesomeness;G;9;1381003633;1388274254;7270621;120.215.294.312.169
liamwli/PhoneNumberFixOpen;com.liam_w.phonenumberfix;G;9;1455556089;1463275707;7719618;127.639.186.507.937
ferdinb/remind.me;com.remind.me.fninaber;G;9;1453343241;1461825750;8482509;140.253.125
addb/SnappLock-An-Android-Application-Locker;com.addb.snapplock;G;9;1448498612;1460414178;11915566;197.016.633.597.884
urielsade/Ninja-Runner-2016;com.urielsade.ninjagame;G;9;1470912902;1483270846;12357944;204.331.084.656.085
sqcubes/wifiadbtile;es.sqcub.wifiadb;G;9;1472976434;1485628307;12651873;209.191.021.825.397
javiersantos/Material-ID.Xamarin;com.javiersantos.materialid;G;9;1427806086;1440586254;12780168;211.312.301.587.302
Momy93/NubChat;com.mohamedfadiga.nubchat;G;9;1472511648;1487069138;14557490;240.699.239.417.989
domenukk/viewbert;com.shadoweinhorn.messenger;G;9;1474527877;1489451847;14923970;246.758.763.227.513
retr0spect/QuizTime-Ultimate-Quiz;com.retroid.quiz.time.ultimate.trivia&amp;G;9;1473636342;1488849834;15213492;251.545.833.333.333
karkum/BTransitHelper;org.mad.bus;G;9;1347974563;1364509819;16535256;273.400.396.825.397
zsperske/MachOne;com.zachary.sperske.commute&amp;G;9;1412971654;1431535956;18564302;306.949.437.830.688
andikapratama/furqan;com.pratamalabs.furqan;G;9;1435329121;1455723353;20394232;337.206.216.931.217
EdwardCraft/Android-Game-YellowMonster-;com.mygdx.monsterGameCraftEdward.android;G;9;1468838866;1489552156;20713290;342.481.646.825.397
Sputuks3/pap4sg;sg.org.pap.pickle&amp;G;9;1457337010;1479276694;21939684;362.759.325.396.825
htruong/sophia_oss;com.htruong.inputmethod.latin;G;9;1369853255;1392005509;22152254;366.274.041.005.291
sshipman/RhombusLib;me.cosmodro.app.rhombus;G;9;1335636244;1359255672;23619428;39.053.287.037.037
The--f/PharmacieAndroid;com.pixelstrade.PharmacyTn&amp;G;9;1400375660;1425488648;25112988;415.227.976.190.476
alidabour/Movietwo;com.ali.movietwo;G;9;1452424003;1478386541;25962538;429.274.768.518.518
skaftanis/LookingForTable;com.smyc.kaftanis.lookingfortable&amp;G;9;1458491005;1484698840;26207835;43.333.060.515.873
sebad78/android-integration;com.mercadopago.merchant;G;9;1467295550;1493744650;26449100;437.319.775.132.275
Bradsta/Hipster-Bird-Free;com.gamicarts.hipsterbirdfree&amp;G;9;1447474173;1475128619;27654446;457.249.437.830.688
huwgames/Don-t-Touch-White;com.HuwGames.DontTouchWhite&amp;G;9;1420836402;1453485381;32648979;539.831.001.984.127
manuelsc/Raven-Messenger;com.urbapps.raven;G;9;1429954018;1463000766;33046748;54.640.787.037.037
jiro-aqua/JotaTextEditor;jp.sblo.pandora.jota;G;9;1445155198;1483314993;38159795;630.948.991.402.116
jackbbb95/WriteChinese;com.globe.jackbbb95.writechinese;G;9;1454513738;1493244726;38730988;64.039.332.010.582
JoaquimLey/validate-android;com.xoidre.validarportugal&amp;G;9;1427676464;1471009451;43332987;716.484.573.412.698
axxapy/android.tools.app-ops;axp.tools.appops;G;9;1375710140;1419190927;43480787;718.928.356.481.482
spacerIV/Android-Currency-Converter;com.hyperionsoft.currencyconverter;G;9;1407182196;1455199416;48017220;793.935.515.873.016
santiago-pan/cruceiros-vigo;com.nadisam.cruceirosvigo;G;9;1408883598;1459103059;50219461;830.348.230.820.106
android10/MyResumeAndroidApp;com.fernandocejas.mycv;G;9;1378854547;1429357956;50503409;835.043.138.227.513
imust/pnd;jp.gungho.pad;G;9;1406177851;1459145840;52967989;875.793.468.915.344
celiovasconcelos/keepcallme;me.keepcall.br;G;9;1423131681;1483557793;60426112;999.108.994.708.995
gerosyab/TheClassicMagic8Ball;net.gerosyab.magicball;G;9;1421124707;1493092717;71968010;118.994.725.529.101
kimjisoo/Stripepaper;com.tjm.stripepaper&amp;G;9;1410920080;1488457799;77537719;128.203.900.462.963
Tywholland/RandomNumberGenerator;com.tywholland.rng;F;9;1335396079;1416446983;81050904;134.012.738.095.238
WillyShakes/KeepInTouch;com.willycode.keepintouch;G;10;1447737225;1452747124;5009899;828.356.316.137.566
tiefenb7/BEA-AndroidJobAnalyzer;developer.bluestardiamond;G;10;1445740502;1452096380;6355878;105.090.575.396.825
nicslabdev/LockPic;es.uma.lcc.nativejpegencoder;G;10;1393755843;1400517723;6761880;111.803.571.428.571
eldarbabayev/easylearning;com.play.eldarbabayev2.easylearning;G;10;1458266632;1465324782;7058150;116.702.215.608.466
tamsler/android-flash-cards;org.thomasamsler.android.flashcards;G;10;1341861664;1348949545;7087881;117.193.799.603.175
jedimatt42/googletv_ncid;net.cwfk.ig88.ncid;G;10;1367688019;1374815512;7127493;117.848.759.920.635
himphen/RingtoneRandomizer;hibernate.v2.ringtonerandomizer;G;10;1484037897;1491468722;7430825;122.864.169.973.545
muba1ham/MathOperations;com.basic.operations.math.mathoperations;G;10;1466016613;1473526685;7510072;124.174.470.899.471
muba1ham/Toronto;com.info.mubashir.hamza.roidapp.test.synaptop.toronto;G;10;1466014765;1473526786;7512021;124.206.696.428.571
JonKussmann/Apogee;com.apogeeapp.apogee&amp;G;10;1409794382;1417584601;7790219;128.806.531.084.656
zhucai/pre-camera;com.twinfishlabs.precamera;G;10;1473162835;1481892177;8729342;144.334.358.465.608
devadvance/rootcloakplus;com.devadvance.rootcloakplus;G;10;1389600386;1398468673;8868287;146.631.729.497.355
MaysaraHolmes/electricity-alarm;com.maysara.maysara.electricity;G;10;1482874971;1492191393;9316422;154.041.369.047.619
lostjared/Mutatris_Android;com.lostsidedead.mutatris;G;10;1461827650;1471298945;9471295;156.602.099.867.725
samratsakthi/Groupon-UI;com.groupon;G;10;1440019884;1450029181;10009297;165.497.635.582.011
miki995/Filozofski_Fakultet_Pale;com.inc.miki.filozofski_falutet_pale;G;10;1476723077;1488108696;11385619;188.254.282.407.407
DarylJtn/EscapistAndroid;com.app.escapistandroid;G;10;1405469574;1417187701;11718127;193.752.099.867.725
W4pity/GPS-Tracer;com.w4pity.gps_tracer&amp;G;10;1461144846;1473237770;12092924;19.994.914.021.164
exelban/TicTakToeWear;ua.org.msv.tiktaktoewear;G;10;1476492024;1489963314;13471290;222.739.583.333.333
chaimt/JewishDay;com.turel.jewishday;G;10;1476977180;1490469885;13492705;223.093.667.328.042
michaelbruno/vampire-detector;com.apollonarius.vampiredetector&amp;G;10;1431705320;1445443766;13738446;227.156.845.238.095
kgmhk/coffeelist;com.kgh.coffelist;G;10;1391934884;1406536277;14601393;241.425.148.809.524
LightnGames/MixyonBlade;com.LightnGames.MixyonBlade;G;10;1456887710;1471867285;14979575;247.678.158.068.783
sevakkalpesh315/Airport_Status;com.airportlive;G;10;1424434918;1443295196;18860278;311.843.220.899.471
derDeno/Wochentags-Rechner;de.pixelart.wochentagsrechner;G;10;1432224475;1451840983;19616508;324.347.023.809.524
amank22/GalgotiasUniversity-mSim;com.aman.teenscribblers.galgotiasuniversitymsim;G;10;1446202160;1466430452;20228292;3.344.625
kumabotz/tappy;com.ftwaves.tappy.free;G;10;1393552505;1413883029;20330524;336.152.843.915.344
r3pwn/Configurator;com.r3pwn.configurator;F;10;1405096901;1426172561;21075660;348.473.214.285.714
abuscher/AeroToolbox;com.buscher.android.aerotoolbox;G;10;1446590725;1468724383;22133658;365.966.567.460.317
cuca24/HZ-vozni-red-wearable;com.cuca.hzvozniredwear&amp;G;10;1407958060;1431163046;23204986;383.680.324.074.074
Sublimis/UrgentCallFilter;com.sublimis.urgentcallfilter;G;10;1409619184;1433158329;23539145;389.205.439.814.815
kennydude/Speaker;me.kennydude.speaker;F;10;1308590214;1332168642;23578428;38.985.496.031.746
BandTec/SerialBTControl;br.com.bandtec.serialbtcontrol;G;10;1402845133;1426855557;24010424;396.997.751.322.751
whueric/DATA-OFFON;com.whueric.dataonoff;G;10;1445417803;1469937561;24519758;405.419.279.100.529
JohannBlake/CanadianPostalCodeKeyboard;info.johannblake.widgets;G;10;1448553683;1473955104;25401421;419.997.040.343.915
lucasmlima08/Eduka_Android;uepb.computacao.eduka;G;10;1432414535;1461014211;28599676;472.878.240.740.741
indywidualny/fNotifier;org.indywidualni.fnotifier;G;10;1435084127;1465674561;30590434;505.794.212.962.963
indywidualny/CatFinder;org.indywidualni.catfinder;G;10;1427825833;1460386820;32560987;538.376.107.804.233
manojkhannakm/Aaruush13;com.webarch.aaruush13;G;10;1458290696;1492937641;34646945;572.866.154.100.529
dmdavids/GuildViewerApp2;com.skywomantechnology.app.guildviewer;G;10;1412547110;1449190918;36643808;605.883.068.783.069
Harrison1/Segify;com.harrisonmcguire.segify&amp;G;10;1424505084;1462864333;38359249;634.246.841.931.217
corbinlc/GNURootRSInstaller;com.gnuroot.rsinstaller;G;10;1440605278;1480544162;39938884;660.365.145.502.646
ytRino/thKinoko;net.nessness.android.thkinoko;G;10;1347164086;1392115122;44951036;743.238.029.100.529
termopetteri/depart-android;com.sekakuoro.depart;G;10;1443119327;1488704728;45585401;753.726.868.386.243
benawad/stack-calculator;benawad.com.stackcalculator;G;10;1426944582;1472744766;45800184;757.278.174.603.175
justinjung04/bots-android;com.luxl.botsandroid;G;10;1416537479;1462863838;46326359;765.978.158.068.783
s11113153/KidPalForAndroid;com.albers_creation.kidpal&amp;G;10;1406790231;1473527337;66737106;110.345.744.047.619
desaster/sdcardwatcher;com.desaster.sdcardwatcher;G;10;1347854860;1416140205;68285345;112.905.663.029.101
cabelo/droidOpenDataBr;com.cabelo.droidOpenDataBr;G;10;1310096135;1385054121;74957986;123.938.468.915.344
575833749/NFCDemo;com.sinpo.xnfc;G;10;1353835802;1437476834;83641032;138.295.357.142.857
osiux/ecobici-android-old;com.repsis.android.ecobici;G;10;1298281210;1393416221;95135011;157.299.952.050.265
arunsaikrish/Festember-13-Android-App;com.festember.f13;G;10;1375902962;1473043233;97140271;16.061.552.744.709
richardtan/CurrencyConverter;com.tckr.currencyconverter;G;10;1373129672;1472471415;99341743;16.425.552.744.709
songshimvp/android-vnc-viewer;android.androidVNC;G;10;1300740115;1448285402;147545287;243.957.154.431.217
johnlazzarini/counting-sheep;com.johnlazzarini.countingsheep&amp;G;11;1484783500;1490735626;5952126;984.147.817.460.317
dawidkotarba/ColorSpreeHD;com.dk.colorgame.android&amp;G;11;1451508615;1458164096;6655481;110.044.328.703.704
vottakvot/WallpaperCristmasTree;ru.testsimpleapps.lifewallpapertree;G;11;1477934913;1484680766;6745853;11.153.857.473.545
DolphinWing/QciAutoGuest;com.quanta.pobu.apps.AutoGuest;G;11;1371187043;1378225538;7038495;116.377.232.142.857
leolin310148/IsBadgeWorking.Android;me.leolin.isbadgeworking;G;11;1478114896;1486190299;8075403;133.521.875
2dep4u/BubbleTrouble;com.BugaStudios.BubbleTrouble;G;11;1457143832;1465516751;8372919;138.441.121.031.746
firesunCN/preventUnexpectedCall;cn.firesun.preventUnexpectedCall;G;11;1440917435;1452081387;11163952;184.589.153.439.153
vibhudadhichi/Windy-Weather;com.vibhu.whatstheweather;G;11;1474799200;1486554822;11755622;194.372.056.878.307
Sublimis/GlowMyMind;com.sublimis.glowalert;G;11;1379603770;1391423812;11820042;195.437.202.380.952
tylerburnham42/Android-Ultimate-HAM-Prep;com.tylerburnham42.ultimateHAMPrep&amp;G;11;1468807090;1482197892;13390802;221.408.763.227.513
AGS-/SignatureDialogFragment;com.angelgomezsalazar.signaturedemo;G;11;1459064447;1472488359;13423912;221.956.216.931.217
kevinli9094/CookAssistant;cookingAssistant.kevin92.com&amp;G;11;1475709131;1490710504;15001373;24.803.857.473.545
mridang/microchip;com.mridang.throttle;G;11;1443882282;1458907492;15025210;248.432.705.026.455
shikk/myremainpri;biz.bokhorst.xprivacy.pro;G;11;1419692109;1434902708;15210599;251.497.999.338.624
monossido/SpeakBird;com.lorenzobraghetto.speakbird;G;11;1332771563;1348654970;15883407;262.622.470.238.095
mohitmanuja/SafePalm;com.safepalm;G;11;1476653771;1492719340;16065569;265.634.408.068.783
AlexKorovyansky/CarWashForecaster;com.alexkorovyansky.carwashfor;G;11;1373894259;1390319842;16425583;271.587.020.502.646
rngtng/IrDude;com.peel.app&amp;G;11;1365080508;1384250742;19170234;316.968.154.761.905
niclashalvorsen/DHISmessenger;org.dhis2.messaging;G;11;1422043865;1444159831;22115966;365.674.041.005.291
syntafin/TenguChat;de.tengu.chat&amp;G;11;1469883687;1492462546;22578859;37.332.769.510.582
Rohitp01/Movies-Now;com.application.android.moviesnow&amp;G;11;1450463913;1473329264;22865351;378.064.666.005.291
amalik12/Draftpro;com.retrograde.dota.dotadraft;G;11;1434407903;1457982084;23574181;389.784.738.756.614
mkhuda/emsi-tether;com.emsilabs.emsitether;G;11;1465746013;1493296806;27550793;455.535.598.544.974
gruessung/OweApp;de.gvisions.oweapp;G;11;1368909350;1396808568;27899218;461.296.593.915.344
utolosa002/BerziklApp;gipuzkoa.hondakinak;G;11;1386887429;1417193564;30306135;501.093.501.984.127
alvarosg88/Yavin-AndroidWebglVR-demo;com.hbasg.yavin;G;11;1453919265;1485819869;31900604;527.457.076.719.577
lennonjesus/bmwg650gs-countdown-android;net.bmwg650gs&amp;G;11;1455530592;1488027314;32496722;537.313.525.132.275
WNeZRoS/LocatorViaSms;com.wnezros.locatorviasms;G;11;1460250502;1493850282;33599780;555.551.917.989.418
punitlohani93/FurtadosMusicApp;com.furtados.highapp;G;11;1458110630;1492733164;34622534;572.462.533.068.783
VoidChen/SCU_WiFiAuth;tw.voidchen.SCU_WiFiAuth;G;11;1399102853;1438591949;39489096;652.928.174.603.175
Rafagf/HealthTube;com.healthtube;G;11;1392988427;1433079817;40091390;662.886.739.417.989
Frozenbox/frozenchat;org.frozenbox.frozenchat.sharelocation&amp;G;11;1415809808;1458247873;42438065;701.687.582.671.958
prempalsingh/arcade-watchface;com.prempal.arcadewatchface;G;11;1434295713;1477852850;43557137;720.190.757.275.132
bddesai/GoBART;com.source.bhavin.gobart;G;11;1434610110;1487212356;52602246;869.746.130.952.381
Dewep/IntranetEpitech;net.dewep.intranetepitech;G;11;1368739419;1424781998;56042579;926.629.943.783.069
jinmanjung/jinmanjung;com.drogsin.rsspotal;G;11;1389944360;1457425171;67480811;111.575.415.013.228
loisaidasam/mta-fare-buster-android;com.kineticfactory.mtacalc;G;11;1414155840;1493914979;79759139;131.876.883.267.196
yoggy/p5_sumaho_player;net.sabamiso.p5_sumaho_player;G;11;1396618268;1482581325;85963057;142.134.684.193.122
kafeg/anagrams;com.kafeg.Anagram;G;11;1322237595;1460317937;138080342;228.307.443.783.069
TakuKobayashi/AndroidDeepLinkAndRefererSample;com.taku.kobayashi.refarorsample;G;12;1426934510;1431886885;4952375;818.845.072.751.323
pragyagrawal/to.do;com.binarybricks.mytodolist;G;12;1466707372;1473212422;6505050;107.557.043.650.794
puntubabu/VipassanaHelper;com.vipassanatimerapp;G;12;1450055375;1456884878;6829503;112.921.676.587.302
RinTran/tim-nao;com.thienphuoc.tpkaraoke;G;12;1456923569;1463994827;7071258;116.918.948.412.698
TheSheeps/PPG;org.thesheeps.ppg&amp;G;12;1432151615;1439817197;7665582;126.745.734.126.984
theunbelievablerepo/Gapps;com.biophysics.google_news;G;12;1397660932;1405530376;7869444;130.116.468.253.968
karanvs/hiddenshot;com.veer.newsblast;G;12;1484818461;1493362916;8544455;141.277.364.417.989
frankkienl/LiveViewNotifications;nl.frankkie.livenotifications;G;12;1371991661;1380735498;8743837;144.574.024.470.899
ehalferty/PghTraffic;com.ehalferty.pghtraffic;G;12;1333954921;1343800718;9845797;162.794.262.566.138
dmitriy-deomin/Random;dmitriy.deomin.random;G;12;1481437783;1491411041;9973258;164.901.752.645.503
maeldiy/phone_door;com.rcreations.ipcamviewer&amp;G;12;1366223946;1376771629;10547683;174.399.520.502.646
christinem/GradeCalculator;com.murad.gradecalculator&amp;G;12;1416897115;1428975235;12078120;199.704.365.079.365
meer07/QiitaReader;com.meer07.qiitamagazine;G;12;1411985598;1424073160;12087562;199.860.482.804.233
havidarou/Pagoda-Free;com.havidarou.pagoda;G;12;1385391189;1399053196;13662007;225.892.972.883.598
mchun/HKConverter;com.hkconverter;G;12;1412698417;1429680502;16982085;280.788.442.460.317
NordicSemiconductor/Android-nRF-Beacon-for-Eddystone;no.nordicsemi.android.nrfbeacon.nearby;G;12;1460648744;1478103792;17455048;288.608.597.883.598
The1andONLYdave/android_overlay;com.dlka.android.apps.android_overlay;G;12;1390067548;1410518261;20450713;338.140.095.899.471
Dhanush123/PhotoTagger;com.x10host.dhanushpatel.phototagger;G;12;1449830549;1470384064;20553515;339.839.864.417.989
thalespf/wizard-maker-android;com.thalespf.library.wizardmaker.samplelist;G;12;1365306461;1386006682;20700221;342.265.558.862.434
HeChinese/OpenHeInput-Android;net.HeZi.Android.HeInput;G;12;1449273318;1471185895;21912577;362.311.127.645.503
divol/arclatvedas_android_studio;com.alv.app;G;12;1463559817;1487758785;24198968;400.115.211.640.212
CharlesAE/ColorInvaders;com.colorinvaders.android;G;12;1443213194;1468008667;24795473;409.978.058.862.434
tbarbette/HTTPLocalePlugin;be.itstudents.tom.android.httplocaleplugin;G;12;1424365221;1451250178;26884957;44.452.640.542.328
maortoubian/ToDoToday;il.ac.shenkar.todotoday;G;12;1427461018;1457031150;29570132;48.892.414.021.164
filiperamon/GameRandonBall-Android;wiiber.com.gamerandomball&amp;G;12;1448904244;1479299530;30395286;502.567.559.523.809
nozokada/JapaneseLDSQuad;com.nozokada.JapaneseLDSQuad;G;12;1435816366;1475549872;39733506;656.969.345.238.095
mi7flat5/Preconception-Health-App;org.PreConceptionHealth.V1&amp;G;12;1446654163;1486933212;40279049;665.989.566.798.942
PhaniGaddipati/Stacks-Flashcards;org.centum.android.stack&amp;G;12;1396239624;1447800925;51561301;852.534.738.756.614
alt236/Wifi-Key-Recovery---Android;aws.apps.wifiKeyRecovery;G;12;1330044994;1394223939;64178945;106.115.980.489.418
dillbyrne/HashPass;byrne.utilities.hashpass;G;12;1394060775;1460229312;66168537;109.405.649.801.587
motoy3d/SmartJ-for-Marinos;smartj.marinos&amp;G;12;1418584236;1488117620;69533384;11.496.921.957.672
WNeZRoS/NumbersConvert;com.app.numconv;G;12;1346268523;1421786732;75518209;124.864.763.558.201
cricklet/Auto-Wallpaper-for-reddit-;com.autowallpaper.free&amp;G;12;1407155777;1483299879;76144102;125.899.639.550.265
dermotte/memory-game-android;at.juggle.games.memory;G;12;1400075480;1481234314;81158834;134.191.193.783.069
alt236/KeyEvent-Display---Android;aws.apps.keyeventdisplay;F;12;1329690184;1474741044;145050860;239.832.771.164.021
mkttanabe/stone-for-Android;jp.klab.stone;G;12;1307079271;1487126008;180046737;297.696.324.404.762
ROKOLabs/ROKOmoji.Emoji.Keyboard.App-Android;com.rokolabs.keyboard&amp;G;13;1486141303;1492640310;6499007;107.457.126.322.751
mompes/supermanager;es.mompes.supermanager;G;13;1382379325;1389006639;6627314;109.578.604.497.354
rishelarora/AES256PasswordBasedEncryption-Decryption;aes.secureencryptdecrypt;G;13;1462956740;1469601871;6645131;109.873.197.751.323
sylvek/sharemyposition;net.sylvek.sharemyposition;G;13;1397735702;1404457251;6721549;111.136.722.883.598
CoffeeCode/YaPwG;info.ap.yapwg&amp;G;13;1389216352;1395965047;6748695;11.158.556.547.619
h-adachi/IRController;h_adachi.com.ircontroller;G;13;1474623298;1481520164;6896866;114.035.482.804.233
myntapps/Pianod-Remote;com.gmail.app.mynt.pianodremote;G;13;1434786138;1442118547;7332409;121.236.921.296.296
akarshsingh9/CodeInPython;com.codeinpython.codeinpython;G;13;1483688206;1491021986;7333780;12.125.958.994.709
jujinesy/unity_basketball_game;com.skakac.bshootout;G;13;1479403269;1487860154;8456885;139.829.447.751.323
hanspeide/dashclock-yr-extension;com.ctrlplusz.dashclock.yr;F;13;1361119148;1370206145;9086997;150.247.966.269.841
squallstar/quickly-android;com.squallstar.quickly;G;13;1435188319;1444644783;9456464;156.356.878.306.878
polatic/pantaudki;com.polatic.pantaudki;G;13;1398550065;1408075539;9525474;157.497.916.666.667
trakos/tekkit-recipe-list;pl.trakos.TekkitRecipeList;G;13;1396384932;1407865948;11481016;189.831.613.756.614
ajavamind/NX500Capture;com.andymodla.remotecapture;G;13;1477509291;1490554703;13045412;21.569.794.973.545
yati-sagade/orch;io.explog.orch;G;13;1461352623;1474572984;13220361;218.590.625
pbhoiwala/GradeTracker;com.bhoiwala.grades.gradetracker;G;13;1478306014;1491592877;13286863;21.969.019.510.582
rujoota/Inviks1;com.aranoah.healthkart.plus&amp;G;13;1434836212;1448145352;13309140;220.058.531.746.032
koalahamlet/kartography;mikecanco.de.kartography;G;13;1417393259;1431417091;14023832;231.875.529.100.529
Waboodoo/Status-Bar-Tachometer;ch.rmy.android.statusbar_tacho;G;13;1429610551;1444573448;14962897;247.402.397.486.772
DimaKhaver/Android-timer;com.e.bullsandcows;G;13;1473614990;1489398469;15783479;260.970.221.560.847
jlmalone/Brief;com.techventus.wikipedianews;G;13;1472071419;1491860138;19788719;327.194.427.910.053
tajchert/Wearly;com.nordeck.wear.timelyface;G;13;1409008913;1429349662;20340749;336.321.908.068.783
kiyell/Reaction-VS;com.kiyell.game.reactionvs.android;G;13;1431555895;1454878144;23322249;385.619.196.428.571
mohamedelfiky/LearningVocabulary;com.vocabulary.learning.lVOc;G;13;1459928127;1486943642;27015515;446.685.102.513.228
fasmide/app-cm-nightlies;dk.mide.fas.cmnightlies;G;13;1332849525;1361620930;28771405;47.571.767.526.455
anjovazquez/ScrumTimer;com.avv.scrumtimer;G;13;1462432507;1491224815;28792308;476.063.293.650.794
mridang/gasflow;com.mridang.speedo;G;13;1443881786;1474787027;30905241;51.099.935.515.873
stefanhaustein/emojic;org.flowgrid.emojic;G;13;1427420401;1459711254;32290853;533.909.606.481.481
gruessung/IchLeiheDir40;de.gvisions.oweapp&amp;G;13;1446322030;1482223618;35901588;593.610.912.698.413
peternijssen/mypetsage;nl.peternijssen.mypetsage&amp;G;13;1377725389;1415387194;37661805;622.715.029.761.905
ovictorpinto/Verdinho;com.github.ovictorpinto.verdinho;G;13;1448930932;1487719100;38788168;641.338.756.613.757
IntegersOfK/Beer-Converter;ca.ajwest.BeerConverter;G;13;1311454546;1354323354;42868808;708.809.656.084.656
mittalharsh2810/StickyNotes;genius.mohammad.floating.stickies;G;13;1365991293;1411785423;45794130;757.178.075.396.825
ganeshskudva/Android_BART_app;com.gkudva.bart;G;13;1445834899;1493182394;47347495;782.862.020.502.645
ramitsuri/ClipSave;com.ramitsuri.clipsave;G;13;1428324080;1478917125;50593045;83.652.521.494.709
suheb/MusicTimer;com.haloappstudio.musictimer;G;13;1425052534;1477927015;52874481;874.247.371.031.746
InstituteOfErgonomics/MDT;de.tum.mw.lfe.mdt;G;13;1394455707;1449138469;54682762;904.146.197.089.947
terokaisti/TxRxWidget;net.kaisti.txrxwidget&amp;G;13;1310804883;1367780901;56976018;94.206.378.968.254
mark3049/PI-Calculator;com.markchung.picalculator;G;13;1347524371;1405048302;57523931;951.123.197.751.323
amsoftgroup/dcmetro_android;com.sombrerosoft.android.wmata;G;13;1361460960;1427414368;65953408;109.049.947.089.947
CreamEgg/mysoftwareprojects;com.cream.egg;G;13;1384023745;1457890423;73866678;122.134.057.539.683
demitsuri/cm-porting-helper;com.litecoding.cmportinghelper;G;13;1360474850;1441692703;81217853;134.288.778.108.466
d4rken/audiobug;eu.thedarken.audiobug;G;13;1397873395;1487450642;89577247;14.811.052.744.709
Noxalus/Age-of-Empires-2-Taunts;com.noxalus.app;G;13;1385077438;1475424765;90347327;14.938.380.787.037
banasiak/CoinFlipExtExample;com.banasiak.coinflipext.example;F;13;1326578935;1454552633;127973698;211.596.722.883.598
marcus905/android-wifi-ace;org.marcus905.wifi.ace;G;13;1282143869;1426501659;144357790;238.686.822.089.947
rafalbednarczuk/Chat;rafalbednarczuk.chat;G;14;1476562565;1481993449;5430884;897.963.624.338.624
wakhub/tinyclock;com.github.wakhub.tinyclock;G;14;1412862573;1418565516;5702943;942.946.924.603.175
henqs/On-A-Boat;com.frostskadad.henq.sailinggadgets;G;14;1465034877;1470858205;5823328;962.851.851.851.852
ScienceSoft-Inc/XamarinDiscountsApp;com.sciencesoft.discounts;G;14;1434094725;1440064668;5969943;98.709.375
HermantNET/Sourcetom;com.sourcetom&amp;G;14;1477768948;1484056800;6287852;103.965.806.878.307
TheSZ11/Toggle;com.szaidi.silentmodetoggle;G;14;1383189394;1391455501;8266107;136.675.049.603.175
KwangsubAhn/Android_App_MayWeather;barogo.mayweather;G;14;1437170279;1445647494;8477215;140.165.591.931.217
yonathansebhastian/runrooney;com.toonybyte.runrooney;G;14;1459840599;1470058618;10218019;168.948.726.851.852
kosamail/Fastlight;com.andrey.kostin.fastlight;G;14;1446192860;1456987761;10794901;178.487.119.708.995
takyonxxx/Elm327;com.obdelm327pro;G;14;1480937322;1492085573;11148251;184.329.546.957.672
tenaciousRas/android-hst-feed;com.longevitysoft.android.appwidget.hstfeed;G;14;1412205011;1423853875;11648864;192.606.878.306.878
carles-ruis/android-size-m;com.carles.sizematters;G;14;1396715448;1410777875;14062427;232.513.673.941.799
tim-sueberkrueb/mygus-touch;gq.mygus.android;G;14;1436719384;1453722332;17002948;281.133.399.470.899
Stimim/TarotHelper;com.stimim.tarothelper;G;14;1374908209;1393159784;18251575;301.778.687.169.312
jmyrland/DriSMo;com.drismo;F;14;1317496810;1336215254;18718444;309.498.082.010.582
louffoster/BlastWords;com.studio332.blastwords&amp;G;14;1372014568;1391479902;19465334;321.847.453.703.704
JuanGarciaLucena/MyCVApp;emebesoft.com.mycvapp;G;14;1470131313;1490097428;19966115;330.127.562.830.688
nagasakulllo/KanazawaEvent;com.kanazawaevent&amp;G;14;1455328096;1475929334;20601238;340.628.935.185.185
panicstyle/aGongdong;com.panicstyle.Gongdong;G;14;1467517850;1488935544;21417694;354.128.538.359.788
marin-liovic/Fast-Brightness-Control-Widget;com.mod.android.widget.fbcw;G;14;1372871901;1394370298;21498397;355.462.913.359.788
JMB-Technology-Limited/Shoogle-For-Yer-Photos-Android;uk.co.jarofgreen.shakefromgallery;G;14;1361005515;1384420314;23414799;387.149.454.365.079
project-voodoo/audio-measurements-player-app;org.projectvoodoo.audiomeasurementsplayer;G;14;1338149527;1361666305;23516778;388.835.615.079.365
oasis789/Arabic-Almanac;com.etjaal.arabicalmanac&amp;G;14;1395442678;1419449004;24006326;396.929.993.386.243
myBeat/WHS-2-Android;jp.co.uniontool.whs2mybeat&amp;G;14;1387857236;1413357405;25500169;421.629.778.439.153
AhnChris/WeatherApp;com.chrisahn.weatherapp;G;14;1428398689;1455861791;27463102;454.085.681.216.931
gauthamns/android-mvc;com.gauthamns.fantasycricket;G;14;1387337165;1414870209;27533044;45.524.212.962.963
Nomad1/NomadReader;com.foobnix.pdf.reader;G;14;1444115887;1478706032;34590145;571.927.000.661.376
Carr3ra/AlaBasket;com.JayCee.AlaBasket;G;14;1425219162;1460135812;34916650;577.325.562.169.312
Gardencoder/wwiiol;archer.handietalkie;G;14;1443253508;1478262552;35009044;578.853.240.740.741
Katalune/Puzzle15Plus;ua.pp.kata.puzzle15plus;G;14;1441832677;1481404720;39572043;654.299.652.777.778
NSchock/ClockProject;com.shockwave.clockproj.free;G;14;1349495718;1397787290;48291572;798.471.759.259.259
InstituteOfErgonomics/RadioTuning;de.tum.mw.lfe.radio;G;14;1427300209;1477915472;50615263;836.892.576.058.201
tjerkw/android-camera-faces;com.mobepic.camerafaces;G;14;1395911014;1446586240;50675226;837.884.027.777.778
alexdbooth/Simple-Stack;com.foxo.simplestack.android;G;14;1421009133;1474742641;53733508;88.845.085.978.836
lucasdaddiego/simple_keyboard;unnoba.teclado;G;14;1403556363;1457727836;54171473;89.569.234.457.672
ZlodeiBaal/Recognitor;org.opencv.samples.tutorial334565;G;14;1399412252;1458515278;59103026;977.232.572.751.323
mickadam/PinholeCalculator;com.madam.PinHoleCalculator;G;14;1345024125;1409517175;64493050;106.635.333.994.709
mavidser/attendance-viewer;com.juet.attendance;G;14;1396175222;1461209040;65033818;107.529.460.978.836
MFlisar/LicensesDialog;com.michaelflisar.licensesdialogdemo;G;14;1375788629;1445433982;69645353;115.154.353.505.291
loveyu/WifiPwd;net.loveyu.wifipwd;G;14;1411389773;1491736837;80347064;132.848.981.481.481
ramandeep-bakshi/Flash-Torch;com.ramandeepbakshi.flashtorch;G;14;1405512380;1488144559;82632179;136.627.280.092.593
avinash311/nyc-metrocard-refill;com.aczoom.nycmetrocard;G;14;1405889007;1491409194;85520187;141.402.425.595.238
edward9145/BeetleGo;game.edw.beetlego;G;14;1348131458;1450314721;102183263;16.895.380.787.037
nfllab/SimplePackageInfo;com.nfllab.android.simplepackageinfo;G;14;1360108014;1468108619;108000605;178.572.428.902.116
sandeel/Bushido-Blocks;com.me.drop&amp;G;14;1364511107;1492411943;127900836;21.147.625
rpandey1234/Algorithm-Helper-deprecated;edu.stanford.algorithms;G;14;1333131486;1486289255;153157769;253.237.051.917.989
pebbe/AndroidFracLand;nl.xs4all.pebbe.fracland;G;15;1481378987;1486484169;5105182;84.411.078.042.328
Chingiz/AwefactApp;devstudio.awefact;G;15;1427572929;1432705757;5132828;848.681.878.306.878
MaryAPc/SpeakingChat;com.maryapc.speakingchat;G;15;1485955260;1491557616;5602356;926.315.476.190.476
paulwongkwan/LiteGAG;mememe.litegag;G;15;1462534226;1468150747;5616521;928.657.572.751.323
Daniel-Wang/mix;danielwang.com.musictime&amp;G;15;1479432078;1485117598;5685520;940.066.137.566.138
xsota/PoopInStatusBar;com.xsota.poop.poopinstatusbar;G;15;1456919157;1462673774;5754617;951.490.906.084.656
DizzyThermal/Auto-Away;com.teamdc.stephendiniz.autoaway;F;15;1364785504;1370631238;5845734;966.556.547.619.048
omerjerk/stickTracker;com.omerjerksticktracker;G;15;1365094593;1371150152;6055559;100.124.983.465.608
swiggins83/rss-dashclock;net.nurik.roman.dashclock&amp;G;15;1369405161;1377721240;8316079;137.501.306.216.931
marcineq1988/GoodJob;mpikula.goodjob;G;15;1453055618;1461605404;8549786;141.365.509.259.259
PramodShenoy/SOULace;com.bkcd.soulace.sample;G;15;1477217418;1486147971;8930553;147.661.259.920.635
dawud-tan/Interoperability;id.co.blogspot.datacomlink;G;15;1483595480;1492636229;9040749;149.483.283.730.159
TheFinestArtist/TheFinestArtist-Android;com.utopia.thefinestartist;G;15;1380620754;1389885060;9264306;153.179.662.698.413
xuyuwei/FX-News;com.yuweixu.fxnews;G;15;1412183546;1421890598;9707052;160.500.198.412.698
aptmac/HiraKana;ume_studios.example.com.hirakana&amp;G;15;1424465628;1435873546;11407918;188.622.982.804.233
YourDataStories/YDS-mobile-application;gr.atc.yds;G;15;1481209095;1492789321;11580226;191.471.990.740.741
victoraldecoa/peixe-android;pcs2420.app.peixe;G;15;1352479663;1366653337;14173674;234.353.075.396.825
blasd/androidusertracker;blasd.wishset&amp;G;15;1379248239;1394726815;15478576;255.928.835.978.836
matt-allen/loaned-android;com.mattallen.loaned;G;15;1397997955;1413736657;15738702;260.229.861.111.111
brandonbryan12/Trumpsweeper;com.brandonferrell.trumpsweeper&amp;G;15;1459302068;1475635687;16333619;270.066.451.719.577
acastr7/CheapSharkMobile;com.acastro.sprite.deals;G;15;1428186525;1444777596;16591071;274.323.263.888.889
Monsieur-Red/PokeAssistant;com.perso.red.pikaassistant;G;15;1472497253;1489583066;17085813;282.503.521.825.397
auxua/L2PNewsTicker;com.auxua.l2pnewsticker&amp;G;15;1456666860;1474585893;17919033;296.280.307.539.683
shengoo/batterystatus;com.sheng00.BatteryStatus;G;15;1397034267;1415808302;18774035;31.041.724.537.037
dondido/AlienSiege;com.publicgamelibrary.aliensiege;G;15;1392756275;1411574889;18818614;311.154.332.010.582
bbreukelen/PositionSender;com.vbreukelen.positionsender;G;15;1456607387;1475679594;19072207;315.347.337.962.963
bhaskargurram/PopularMovies;com.bhaskar.popularmovies;G;15;1454777184;1475780797;21003613;347.281.960.978.836
Goodmorning918/Przelicznik-Walut;com.dawidcisowski.goodmorning.przelicznikwalut;G;15;1460718365;1485427091;24708726;40.854.375
firebirdberlin/android-preferences;my.package.name;G;15;1467885257;1493023520;25138263;415.645.882.936.508
ntorvik/SmartReceiptsPro;wb.receipts;G;15;1367169873;1392349835;25179962;416.335.350.529.101
darshakframework/darshak;com.darshak;G;15;1408049481;1435234460;27184979;449.487.086.640.212
Catah97/BlueTooth_Terminal;appforceone.bluetooth_terminal;G;15;1459780520;1489488269;29707749;491.199.553.571.429
lemberg/mappwidget;com.ls.mappwidgetdemo;G;15;1424378617;1455290020;30911403;511.101.240.079.365
ArianJM/Space-Guardian-Unity;com.arianjm.spaceguardian;G;15;1401384804;1434905565;33520761;554.245.386.904.762
jufabeck2202/IonicCaffeinCalculater;com.ionicframework.coffeintracker624223&amp;G;15;1446138553;1490637148;44498595;735.757.192.460.318
bearprada/android-infinite-scroll;lab.prada.android.ui.mymodule.app;G;15;1384438964;1433200335;48761371;806.239.599.867.725
jesuscea/AgendaEventos;com.cea.eventos;G;15;1403636705;1453932738;50296033;831.614.302.248.677
SimonMarquis/Android-InstallReferrer;fr.simon.marquis.installreferrer&amp;G;15;1412436497;1471536482;59099985;977.182.291.666.667
kimar/DTMFdroid;org.indiecoder.DTMFdroid;G;15;1337101232;1398974373;61873141;102.303.473.875.661
jack-song/Arimaa;email.com.gmail.songjiapei.arimaa;G;15;1421010018;1489521808;68511790;113.280.076.058.201
ftena/TeamGen;com.tarlic.TeamGen;G;15;1361197154;1439597813;78400659;129.630.719.246.032
josenaves/score;com.josenaves.score;G;15;1397433376;1489265338;91831962;151.838.561.507.937
programingjd/justified;com.uncopt.android.example.justify;G;15;1399479522;1491394896;91915374;151.976.478.174.603
eswarm/DebugPurge;in.eswarm.debugpurge;G;16;1469288616;1474301551;5012935;82.885.830.026.455
sivathebest/LoanCalc;com.loancalc.dtailcode.loancalc;G;16;1475248490;1480964547;5716057;945.115.244.708.995
israel-fl/GreenFacades;com.israel_fl.greenfacades;G;16;1459152653;1465372465;6219812;102.840.806.878.307
Andr3as/MobileBattery;de.andrano.mobilebattery;G;16;1437573276;1444046026;6472750;107.022.982.804.233
ethanthomas/BasicAndroidNetworking;com.developers.obsidian.basicandroidnetworking;G;16;1418511105;1426986125;8475020;140.129.298.941.799
dobrowins/zombieweather_github;com.allsouls.dobrowins.allsoulsweather;G;16;1481370830;1492085751;10714921;177.164.699.074.074
tiltshiftfocus/Eventful;fi.zt.timeflies;G;16;1418199721;1429236180;11036459;182.481.134.259.259
TrentPierce/DontPause;com.pierceholdings.dontpause;G;16;1403307171;1415251472;11944301;197.491.749.338.624
dgipps/ss-log;com.danielgipps.sslog;G;16;1387732485;1399689083;11956598;197.695.072.751.323
AlphaDelete/AguaConsciente;alphadelete.aguaconsciente;G;16;1425505661;1437777396;12271735;202.905.671.296.296
deviant-studio/wifi_ninja;ds.wifimagicswitcher;G;16;1444240010;1457214018;12974008;214.517.328.042.328
danielpassos/schedules-android;me.passos.android.schedules;G;16;1334323484;1347824201;13500717;223.226.140.873.016
shmuelr/PicLoco;com.orbitdesign.picloco;G;16;1430154352;1444254048;14099696;233.129.894.179.894
RuiEEE/cadernos-progresso-aep;pt.ruie.cadernoprogresso;G;16;1438976190;1453119456;14143266;233.850.297.619.048
GeoffreyWesthoff/name-generator;com.geoffcoproductions.NameGenerator;G;16;1473720940;1488028005;14307065;236.558.614.417.989
alt236/Under-the-Hood---Android;aws.apps.underthehood;G;16;1334437907;1349219939;14782032;244.411.904.761.905
brandaogabe/TicTacToe;com.brandao.tictactoe&amp;G;16;1458961725;1474160785;15199060;251.307.208.994.709
npaul007/cuetip;cuetip.example.nate.cuetip;G;16;1465586025;1480794672;15208647;251.465.724.206.349
harshadura/Ralapanawa.Mobile.Module;org.ralapanawa.mobile.android;G;16;1345211835;1363749373;18537538;306.506.911.375.661
santidmar/android-fitness-test;com.github.press;G;16;1439336672;1460939279;21602607;357.185.962.301.587
The-Clayman/ClickAndSend;com.r_and_e.click_send;G;16;1427297968;1449097907;21799939;360.448.726.851.852
yswheye/WatchFaceHacker;net.dheera.wearfacematrix;G;16;1420910224;1446102118;25191894;416.532.638.888.889
tim-ashton/Android-Port-Scanner;com.timashton.aportscanner;G;16;1420087394;1445334887;25247493;41.745.193.452.381
pepperonas/MaterialDialog;com.pepperonas.materialdialog.showcase;G;16;1464887512;1492516303;27628791;456.825.248.015.873
pepperonas/M104;com.pepperonas.m104;G;16;1465073231;1493491930;28418699;469.885.896.164.021
wpseek/wpseek-android;com.wpseek.mobile;G;16;1419284652;1448144659;28860007;47.718.265.542.328
kelechizy/Kelechizy-App;com.kelechizy.kelechizyapp;G;16;1460267612;1491699622;31432010;51.970.916.005.291
LeonPoon/ChangiAirportPassengerArrivalsDepartures;com.codepowered.changiairport.passengerarrivalsdepartures;G;16;1417951876;1461508205;43556329;720.177.397.486.772
MFlisar/UniversalLoader;com.michaelflisar.universalloader.demo;G;16;1383162713;1445434411;62271698;102.962.463.624.339
Pi-Developers/Floata-Client;pidevelopers.floata;G;16;1407522165;1474664059;67141894;111.015.036.375.661
franciscofranco/Simple-Reboot-app;simple.reboot.com;G;16;1419191698;1486755549;67563851;111.712.716.600.529
benkaiser/stretto-android-sync;com.kaiserapps.benkaiser.strettoandroidsync;G;16;1406645165;1478327835;71682670;118.522.933.201.058
shivanarrthine/take-away-malaysia;com.narrthine.takeawaymalaysia;G;16;1354950007;1430557870;75607863;125.013.000.992.063
ftena/Triforce;comm.tarlic.triforce;G;16;1361179585;1439943479;78763894;130.231.306.216.931
leefurong/handrite-api;my.handrite;G;16;1354695441;1447520030;92824589;153.479.809.854.497
RafaelKeramidas/SAMPApp;com.rafaelk.sampapp&amp;G;16;1339077405;1440703410;101626005;168.032.415.674.603
softgearko/MultiPing-for-Android;kr.softgear.multiping;F;16;1315534012;1422844570;107310558;177.431.478.174.603
dozingcat/CamTimer;com.dozingcatsoftware.cameratimer;F;16;1313973384;1451359742;137386358;227.159.983.465.608
mark3049/FindExchange;com.markchung.findExchange;G;16;1349159947;1488420874;139260927;230.259.469.246.032
yoggy/SimpleMQTTViewer;net.sabamiso.android.simplemqttviewer;G;17;1426080101;1431951297;5871196;970.766.534.391.534
moonsoo5522/soma_mobile;com.sangjin.soma7th;G;17;1469081064;1475811178;6730114;11.127.833.994.709
bonghyun2/jelly-direction-button;com.bnystudio.jellydirectionbutton;G;17;1455796889;1463057322;7260433;120.046.841.931.217
chrisfrederickson/munch;com.felkertech.n.munch;G;17;1425772388;1433920518;8148130;134.724.371.693.122
CROSP/presenter-layout;ua.com.crosp.solutions.presenterlayout;G;17;1463618916;1474735087;11116171;183.799.123.677.249
SeifMostafa/MallDir;air.com.digitaleg.cairofestivalcityAndroid;G;17;1475244219;1487152870;11908651;196.902.298.280.423
JasonCromer/CSHelper;com.dev.cromer.jason.cshelper;G;17;1442353948;1454480583;12126635;200.506.531.084.656
JA-VON/Chatois;com.chatois.app&amp;G;17;1462001588;1475276657;13275069;219.495.188.492.063
prashantgupta24/Ring-Message;myapp.prashant.ring_message&amp;G;17;1428809692;1443191958;14382266;237.802.017.195.767
locastan/goblins-pixel-dungeon-master;com.locastan.pixeldungeongoblins;G;17;1478520832;1493039763;14518931;240.061.689.814.815
jmgjmg/MSMBle;com.tumaku.msmble;G;17;1394022405;1409247464;15225059;251.737.086.640.212
renancunha33/33seconds;com.renan.seconds33;G;17;1446983980;1462417489;15433509;255.183.680.555.556
androidquery/simplefacebook;com.androidquery.simplefeed;G;17;1319203590;1335610825;16407235;271.283.647.486.772
andreasioannoutech/MyAppPortfolio;com.gcna.dinevenues&amp;G;17;1470761058;1487518167;16757109;277.068.601.190.476
reemhalamish/Budget;halamish.reem.budget;G;17;1445189605;1462478287;17288682;285.857.837.301.587
mikljohansson/blockade;se.embargo.blockade;G;17;1417467519;1436638239;19170720;31.697.619.047.619
wger-project/android;de.wger;G;17;1381266239;1404053270;22787031;376.769.692.460.317
tusharsappal/NewsBurner;com.tusharsappal.newsburner;G;17;1379511061;1406048594;26537533;438.781.960.978.836
richardtan/CYPO;com.tckr.dukcud;G;17;1452371071;1484242675;31871604;526.977.579.365.079
baegmon/BossTimer;baegmon.com.bosstimer;G;17;1437462592;1470412496;32949904;544.806.613.756.614
ashishb/AppInfo;com.ashish.appinfo;G;17;1348466523;1384158954;35692431;590.152.628.968.254
timothyleerussell/RationalCalc;com.snoffleware.android.rationalcalcfree;G;17;1364879585;1400825063;35945478;594.336.607.142.857
nemui/lonebrewerwatchface;deep.dark.lonebrewer;G;17;1427755779;1472824985;45069206;745.191.898.148.148
shengbinmeng/IPGateway;pku.shengbin.ipgateway;G;17;1370098215;1418727145;48628930;804.049.768.518.519
sachindayl/TicTacToe;com.sachinda.myfirstapp;G;17;1415927050;1467334351;51407301;849.988.442.460.318
brandonFaf/SubSink;org.cocos2dx.SubSink&amp;G;17;1420768143;1473461963;52693820;871.260.251.322.751
ValXp/particles;com.valxp.particles;G;17;1372546825;1425864136;53317311;881.569.295.634.921
hexec/ShowUptime;parad0x.show_uptime;G;17;1422699204;1476533054;53833850;890.109.953.703.704
jhhfrancos/fillUp;com.github.wdkapps.fillup;G;17;1373161786;1435290267;62128481;102.725.663.029.101
mchow01/FingerDoodle;edu.tufts.cs.mchow.fingerdoodle&amp;G;17;1297656879;1369924760;72267881;119.490.543.981.481
hoffimar/timerdroid;com.tomatodev.timerdroid;G;17;1401134363;1474045592;72911229;120.554.280.753.968
mpallansch/JumpyBall;com.comli.exampleproject&amp;G;17;1407167598;1491962760;84795162;140.203.640.873.016
nitinarv/StudyGroupX;com.group.studyproject;G;17;1376927717;1477310237;100382520;165.976.388.888.889
ViliusKraujutis/AndroidBroadcastsMonitor;lt.andro.broadcastlogger;G;17;1356389084;1465976646;109587562;181.196.365.740.741
ViliusKraujutis/proximity-screen-locker;lt.kraujutis.vilius.android.screenlocker;G;17;1339968013;1456754626;116786613;193.099.558.531.746
thevladeffect/fed;io.fed.mobile.fedio;G;18;1451308830;1456493734;5184904;857.292.328.042.328
gdgjf/feeling-cast;com.google.android.apps.chromecast.app;G;18;1435121665;1441105233;5983568;989.346.560.846.561
alirezaostovar/codeoffloading;pl.speedtest.android&amp;G;18;1374582947;1380658426;6075479;100.454.348.544.974
frozenprojects/anime-release-notifier-android;com.freezingwind.animereleasenotifier;G;18;1423880690;1430553741;6673051;110.334.837.962.963
danialgoodwin/android-widget-keyboardless-edittext;net.simplyadvanced.examplekeyboardlessedittext.app;G;18;1401894020;1409181190;7287170;120.488.921.957.672
jacekkopecky/parkjam;uk.ac.open.kmi.parking;G;18;1368028422;1376930579;8902157;147.191.749.338.624
vinz313/blurlesspost;com.gmail.vinz313.blurless_imaging_android;G;18;1445955703;1455665743;9710040;160.549.603.174.603
kaidenho/spellcaster;com.kaidenho.spellcaster;G;18;1475437385;1486244572;10807187;178.690.261.243.386
ConsideredHamster/YetAnotherPixelDungeon;com.consideredhamster.yetanotherpixeldungeon;G;18;1479316910;1490423652;11106742;183.643.220.899.471
bfergs/Terra;bfergus.Terra_Wallpapers;G;18;1458028276;1469484955;11456679;189.429.216.269.841
ThimoKl/Meal-Plan-App;cafeteria.multiple.berlin;G;18;1433360326;1445434914;12074588;199.645.965.608.466
itsProf/smart-chimp-android;net.jorgetapia.smartchimp;G;18;1424740623;1439087325;14346702;237.213.988.095.238
billykeyss/TAP;com.simplexlabs.tapexchange&amp;G;18;1422719526;1437500651;14781125;244.396.908.068.783
shznaqvi/PSSP-HHListing;edu.aku.hassannaqvi.pssp;G;18;1476530914;1491567699;15036785;248.624.090.608.466
amritsinghbains/Chamber-Of-Commerce;ca.uwindsor.uwintechclub.chamberofcommerce;G;18;1445225790;1461186024;15960234;263.892.757.936.508
Hellenic/NatureQuiz;net.blankpace.naturequiz;G;18;1430633520;1454254992;23621472;390.566.666.666.667
coreblu/CoreBLU-SDK;gistic.coreblu.Configuration;G;18;1434034855;1458209397;24174542;399.711.342.592.593
lukakama/klets-plugins;com.voicecontrolapp.pluginpack;G;18;1367496879;1392324514;24827635;410.509.837.962.963
dlehdgud2380/Younghoon;com.scoutlee.yhhs&amp;G;18;1416039723;1448278492;32238769;533.048.429.232.804
skulltah/splatapp_android;io.github.skulltah.splatapp;G;18;1444949421;1478363014;33413593;552.473.429.232.804
anastaciakv/LoveQ36;com.peliya.loveq36;G;18;1422435759;1456254276;33818517;559.168.601.190.476
splitowo/Notes;com.bzs2.Notes;G;18;1449066929;1492891238;43824309;724.608.283.730.159
TheSZ11/FlashCode;com.szaidi.flashcode;G;18;1428965025;1473967622;45002597;744.090.558.862.434
ledongthuc/FengShui;vn.com.thuc.fengshui;G;18;1382145346;1428666790;46521444;76.920.376.984.127
mcandre/hello-ruboto;us.yellosoft.helloruboto;G;18;1354857029;1410025572;55168543;912.178.290.343.915
stojshic/G4coresFIx;com.androguide.universal.init.d;G;18;1365894851;1424632310;58737459;97.118.814.484.127
mtac/Randomology;org.jumpingtree.randomology;G;18;1421020442;1483719178;62698736;103.668.544.973.545
lennonjesus/bmwg650gs-countdown-android-legacy;net.bmwg650gs;G;18;1381270014;1456179161;74909147;123.857.716.600.529
christianphan/SimpleStock;com.christianphan.simplestock&amp;G;19;1465525148;1471077479;5552331;918.044.146.825.397
vottakvot/WallpaperAbstract;ru.testsimpleapps.lifewallpaperabstract;G;19;1477934776;1484680422;6745646;111.535.152.116.402
Fifteen15Studios/AutoRespondAPITest;com.havens1515.autorespond;G;19;1483895411;1492537797;8642386;142.896.593.915.344
Diegazo/OLD_CastraServilia;com.castraservilia;G;19;1375722766;1384524301;8801535;145.528.025.793.651
mikes222/BsnsTemplate;com.mschwartz.dailyflightbuddy;G;19;1476724521;1489347607;12623086;208.715.046.296.296
NordicSemiconductor/Android-nRF-BLE-Joiner;no.nordicsemi.android.nrfblejoiner;G;19;1448460670;1462795907;14335237;237.024.421.296.296
keyrunHORNET/date_picker_converter;com.hornet.nepalidateconverter;G;19;1462690813;1478611555;15920742;263.239.781.746.032
charanbir/MovieNotifications;com.movie.android.scheduler;G;19;1473709215;1493752937;20043722;331.410.747.354.497
konr/tomatinho-mobile;com.tomatinho_mobile;G;19;1347235505;1368039244;20803739;343.977.166.005.291
prrt714/UFrame;vnd.blueararat.UFrame;G;19;1344458743;1365504242;21045499;347.974.520.502.646
vrlc92/lisk-android-monitor;com.vrlc92.liskmonitor;G;19;1467079998;1490244921;23164923;383.017.906.746.032
jsvenus/EdenYouTube;com.eden.youtubesample;G;19;1430433382;1453719411;23286029;385.020.320.767.196
RadioHopeUA/Android-GolosNadii;ua.hope.radio.golosnadii;G;19;1464966640;1490578505;25611865;423.476.603.835.979
goolick/FastMaps;com.fastmaps.andrew.fastmaps&amp;G;19;1434464631;1460260731;25796100;426.522.817.460.317
lucasmlima08/SensorsDroid_Android;com.myllenno.androidt.sensores;G;19;1435183873;1461014253;25830380;427.089.616.402.116
neelk07/Pillscribe;info.nk.budge;G;19;1363564787;1389738335;26173548;43.276.369.047.619
JohnSmithWithHaruhi/FindCenterPoint;com.JohnSmithWithHaruhi.wj.findcenterpoint2;G;19;1465561836;1493261835;27699999;458.002.628.968.254
ciubex/keepscreenlock;ro.ciubex.keepscreenlock;G;19;1450620274;1488874540;38254266;632.511.011.904.762
TheSZ11/uWaterlooWeather;com.szaidi.uwaterlooweather2;G;19;1429054766;1473967647;44912881;742.607.159.391.534
thanksmister/BitcoinBlue;com.thanksmister.btcblue;G;19;1436201147;1488993318;52792171;87.288.642.526.455
computerjazz/Defind;com.danielmerrill.defind;G;19;1430805523;1485448359;54642836;903.486.044.973.545
dimalinux/SwipeYours;to.noc.android.swipeyours;G;19;1388903504;1447889567;58986063;975.298.660.714.286
corbinlc/octave4android;com.octave;F;19;1341983039;1402844740;60861701;100.631.119.378.307
daj/flashback;uk.co.danieljarvis.android.flashback;G;19;1385777608;1463194194;77416586;128.003.614.417.989
ftena/RPGDiceRoller;com.tarlic.RPGDiceRoller;G;19;1361207949;1439597835;78389886;129.612.906.746.032
pozirk/ANEAdMob;air.com.pozirk.allinonesolitaire;G;19;1378143225;1459893456;81750231;135.169.032.738.095
johnwalley/strokeme;org.walley.strokeme;G;19;1313437627;1472558397;159120770;263.096.511.243.386
mVaks/Chopsticks-2.0;com.luxser.chopsticksOnline;G;20;1470582507;1476235284;5652777;934.652.281.746.032
monsterkitten/is.gd;com.monsterkitten.is_gd;G;20;1371006026;1377063906;6057880;10.016.335.978.836
ivanob/android-AppPuntalRadioV2;com.ivanob.puntalradio&amp;G;20;1470873426;1477350157;6476731;107.088.806.216.931
takuya320/Momotaro;java_conf.gr.jp.momotaro;G;20;1482769454;1490011011;7241557;119.734.738.756.614
npelly/android-about;org.npelly.android.about;G;20;1480628363;1488770716;8142353;134.628.852.513.228
CrowMash/ICSActualizer;jp.classmethod.us.android.icalsync;G;20;1479281880;1492001570;12719690;210.312.334.656.085
gordontang/Smart-Sleeper;ca.gordontang.smartsleeper&amp;G;20;1405228905;1422756495;17527590;289.808.035.714.286
Hive2Hive/Android;org.hive2hive.mobile;F;20;1413907065;1431779515;17872450;295.510.085.978.836
franvalverde/applicatize;com.info.priego;G;20;1393949682;1413743297;19793615;327.275.380.291.005
Joonho365Han/Ink;eden.notebook.ink;G;20;1436332525;1456169084;19836559;327.985.433.201.058
kmshack/Android-TopScrollHelper;com.kmshack.topscrollsample;G;20;1444110454;1466040309;21929855;362.596.808.862.434
cldrn/lector-bunsen;com.calderonpale.lectorbunsen;G;20;1347082348;1369089105;22006757;363.868.336.640.212
techlung/MoodTrackerAndroid;com.techlung.moodtracker;G;20;1451298062;1473928394;22630332;37.417.876.984.127
madmanteam/QDict;com.annie.dictionary;G;20;1434223061;1457543077;23320016;385.582.275.132.275
praslnx8/volume_Screen_Lock;com.prasilabs.screenlocker;G;20;1452340273;1481248800;28908527;477.984.904.100.529
laowch/GithubTrends;com.laowch.githubtrends.play2&amp;G;20;1444290944;1474453329;30162385;498.716.683.201.058
UCI-ABR/ABR_eDVS;com.ftdi.j2xx.hyperterm;G;20;1405996469;1440366474;34370005;568.287.119.708.995
whiteSkar/Pongu;myGame.pongu;G;20;1414985048;1456891559;41906511;692.898.660.714.286
F43nd1r/LightningPermissionManager;com.faendir.lightning_launcher.permission_manager;G;20;1427510971;1471633131;44122160;729.533.068.783.069
eXeP/Viikki-lukkari;com.pietu.lukkari;G;20;1440276039;1485539762;45263723;748.408.118.386.243
Sleicreider/hazelnut2k15;com.Slei.Hazelnut;G;20;1437991219;1490185917;52194698;863.007.572.751.323
petrovichtim/BatteryWatchFace;com.rusdelphi.batterywatchface;G;20;1433854743;1486743858;52889115;87.448.933.531.746
jsanc623/Android-BattyNotifier;com.jsanc623.batty.notifier&amp;G;20;1357354390;1410976062;53621672;88.660.171.957.672
nboneh/Space-app;com.coluby.androidgames.codebreaker&amp;G;20;1400339166;1457040141;56700975;937.516.121.031.746
aleksz/rss-reader;com.gmail.at.zhuikov.aleksandr.rssreader;G;20;1312832725;1381823137;68990412;114.071.448.412.698
angelospanag/gaia-alert-android;com.angelospanag.android.gaiaalert&amp;G;20;1416221927;1489487812;73265885;12.114.068.287.037
tiratatp/whenwhere;com.nuttyknot.whenwhere&amp;G;20;1329535898;1473711345;144175447;238.385.329.034.392
Simon-Raes/Sudoku-Solver;be.simonraes.sudokusolver;G;21;1406403303;1411407892;5004589;82.747.833.994.709
qrazhan/hunter2;com.qrazhan.hunter2;G;21;1408222417;1413433250;5210833;86.157.953.042.328
saddambilalov/AnimalWelfareApp;animal.welfare.main;G;21;1466709416;1471990862;5281446;87.325.496.031.746
Quoders/madridbus-android;com.quoders.apps.MadridBus;G;21;1473630948;1480268915;6637967;10.975.474.537.037
mozadeh/smartpoll;com.smartiky.smartpoll;G;21;1487125790;1493772297;6646507;109.895.949.074.074
yccheok/GameOfLife;org.yccheok.gameoflife;G;21;1444538200;1451686004;7147804;11.818.458.994.709
mstrey/Sorting;br.nom.strey.maicon.sorting;G;21;1369698030;1377107563;7409533;122.512.119.708.995
felipebaltazar/Promob-Draw;com.promobdraw;G;21;1484621227;1493137220;8515993;140.806.762.566.138
ilyaev/HeartRateZone;com.pbartz.heartmonitor;G;21;1442435518;1452446718;10011200;165.529.100.529.101
michaelcspeed/Pleight;com.speed.platecalc;G;21;1389565015;1399913677;10348662;171.108.829.365.079
nathaliesicard/yoguin-android;com.yoguin.hola;G;21;1464571435;1475860304;11288869;186.654.580.026.455
rambodrahmani/phos-app;com.phos.rambodrahmani.phos;G;21;1457625550;1468941551;11316001;187.103.191.137.566
karkum/HokieHelper;org.mad.app.hokiehelper;G;21;1336331817;1348382970;12051153;199.258.482.142.857
JustinMockler/bluetooth-reboot;com.justinmockler.bluetoothreboot;G;21;1473912470;1493352208;19439738;321.424.239.417.989
zeromaro/Flippo;dingdiling.chineseflashcards;G;21;1453816629;1474360389;20543760;339.678.571.428.571
VenomVendor/DeduplicateSMS;com.venomvendor.sms.deduplicate;G;21;1449076873;1473106095;24029222;397.308.564.814.815
tobijanssen/GSOPlan;de.janssen.android.gsoplan;G;21;1349344200;1374480766;25136566;415.617.824.074.074
enricocid/Storage-USB;com.enrico.filemanager;F;21;1451740871;1478458290;26717419;441.756.266.534.392
thanumoorthy/Android-Projects;com.thanu.yogasanam;G;21;1422350848;1456940630;34589782;571.920.998.677.249
Crx4/AM-FM-Modulator;com.mcnvr.amfmmodulator;G;21;1449850827;1486416613;36565786;604.593.022.486.772
Jimmt/Smite-Training;com.jimmt.smitepractice.android&amp;G;21;1432880245;1469592295;36712050;607.011.408.730.159
harism/android_anndblur;fi.harism.anndblur;G;21;1380459116;1417179812;36720696;607.154.365.079.365
KKorvin/TinyStockQuotes;org.linuxspace.stockquotes;G;21;1421263571;1461958597;40695026;672.867.493.386.243
lablogga/DIYgenomics_Android;org.diygenomics.pg;F;21;1284665727;1327254787;42589060;704.184.193.121.693
KodarKooperativet/NotificationStopwatch;com.kodarkooperativet.notificationstopwatch;G;21;1378112083;1428416117;50304034;831.746.593.915.344
stdev293/battery-waster-android;com.stdev293.batterywasterdemo;G;21;1354409708;1405113288;50703580;838.352.843.915.344
avianey/Level;net.androgames.level;G;21;1348377520;1400069839;51692319;854.701.041.666.667
conorstarrs/DoINeedMyCoat;com.conorstarrs.doineedmycoat;G;21;1368734356;1423940756;55206400;912.804.232.804.233
rickythefox/LockScreenDisableTimer;se.amphisys.lockscreendisabletimer.app;G;21;1433070097;1489149919;56079822;927.245.734.126.984
codeskraps/HeadSet;com.codeskraps.headset;G;21;1333987973;1396399772;62411799;103.194.112.103.175
dermotte/imagegrid;at.juggle.imagegrid;G;21;1401949850;1465394479;63444629;104.901.833.664.021
ciubex/brgen;ro.ciubex.brgen;G;21;1395001904;1488874289;93872385;155.212.276.785.714
MartinHerren/Androiccu;com.aed.tun.installer;G;21;1354983431;1450112378;95128947;157.289.925.595.238
gostaj/MtGoxWidget;st.brothas.ccwidget;G;21;1299013969;1402081047;103067078;170.415.142.195.767
ReptilianInc/SheduleFirebaseApp;com.karpunin.nix.cathedraist;G;22;1483391178;1488306955;4915777;812.793.816.137.566
ragone/QuietMind;ragone.io.quietmind;G;22;1455536286;1460691941;5155655;852.456.183.862.434
danuseubuntu/Dan;net.dheera.wearcamera;G;22;1405090189;1410981866;5891677;974.152.943.121.693
Kuloud/Unity;com.kuloud.android.unity;G;22;1434465339;1440586972;6121633;101.217.476.851.852
emailnitram/fast-break-react-native;com.fastbreak;G;22;1476313496;1483577590;7264094;120.107.374.338.624
kikinteractive/kik-api-android;kik.android&amp;G;22;1409858036;1417715933;7857897;129.925.545.634.921
Pierry/finan;pierrydev.com.br.finan;G;22;1422384746;1430845808;8461062;139.898.511.904.762
AndyMon/CM11-PA_Theme_template;com.botty.theme.next.skyblue;G;22;1403372858;1412250282;8877424;146.782.804.232.804
scognito/Abraboxabra;it.scognito.abraboxabra;G;22;1433107576;1442075350;8967774;148.276.686.507.937
montecode/three-tiles;me.montecode.game.gdx.threetiles.android;G;22;1412540970;1421665419;9124449;150.867.212.301.587
brodeurlv/fastnfitness;com.easyfitness;G;22;1470693905;1480848687;10154782;167.903.141.534.392
spanglerware/Open-Reminder;com.openreminder;G;22;1430539639;1443393694;12854055;212.533.978.174.603
ProjectSPAN/android-manet-visualizer;org.span.visualizer;G;22;1343439617;1360716944;17277327;285.670.089.285.714
jpjodoin/transport-mtl;net.rhatec.amtmobile;G;22;1348592147;1366253658;17661511;292.022.337.962.963
vishalkuo/dotDash;com.vishalkuo.dotDash&amp;G;22;1419383780;1438551973;19168193;316.934.408.068.783
dalong982242260/AndroidCalendar;ws.xsoh.etar;G;22;1465364753;1484717421;19352668;31.998.458.994.709
alexfilatov/desvitlo;com.mavlin.desvitlo;G;22;1418029049;1449419725;31390676;519.025.727.513.228
SeMoNeX/drawer-page-sliding-tab-strip;com.google.android.music;G;22;1375715853;1409855688;34139835;564.481.398.809.524
jcolladosp/daviscope;es.jcolladosp.daviscope;G;22;1443683130;1479824008;36140878;597.567.427.248.677
Ambientic/GoFlowAndroidApp;com.ambientic.goflow.goflowtestapp&amp;G;22;1415810002;1452070466;36260464;599.544.708.994.709
wayrunner/AllCount;com.bitflake.allcount;G;22;1455355471;1492944831;37589360;621.517.195.767.196
djewett/Chess960Variants;dj.chess960var;G;22;1327514906;1365836045;38321139;633.616.716.269.841
flode/SetAndroidProcessLimit;com.intangibleobject.securesettings.plugin;G;22;1407338507;1448104361;40765854;674.038.591.269.841
venomwine/AMCOP;com.amcop.app;G;22;1378212341;1422793313;44580972;737.119.246.031.746
mobiRic/StackFlairWidget;mobiric.demo.flairstackwidget;G;22;1366643494;1411378962;44735468;739.673.743.386.243
easy-weather/android;com.keepiteasy.easyweather;G;22;1374601775;1435077902;60476127;999.935.962.301.587
logomancer/dashquotes-civ5;net.logomancy.dashquotes.civ5;F;22;1374783768;1444432014;69648246;115.159.136.904.762
cnrshantanu/HinduSymbology;com.rethink.hindugodsymbology;G;22;1374565754;1454014298;79448544;131.363.333.333.333
jchmrt/clean-calculator;home.jmstudios.calc;G;22;1379755421;1469565811;89810390;14.849.601.521.164
anvo/piqwi;com.github.anvo.piqwi;G;22;1360861080;1451400384;90539304;14.970.123.015.873
noboru-i/TetherSetting;hm.orz.chaos114.android.tethersetting;G;22;1350925215;1460349834;109424619;180.926.949.404.762
elelinux/GreatFreedom;org.cyanogenmod.great.freedom;G;23;1399741684;1406230877;6489193;107.294.857.804.233
ESTR-eval-app/eval-n-android;ca.stevenlyall.evaln;G;23;1452727503;1460852631;8125128;134.344.047.619.048
hrskrs/GestureFun;com.hrskrs.gesturefun;G;23;1452841681;1462352805;9511124;157.260.648.148.148
wentaozone/tagAR;com.tagAR;G;23;1342943437;1353657243;10713806;177.146.263.227.513
tuyendt6/SamsungPhoneChecker;samsungchecker.tuyenpx.com.samsungchecker;G;23;1463054483;1475459110;12404627;205.102.959.656.085
1gravity/Android-ColorPicker;com.onegravity.colorpicker.demo;G;23;1460438440;1477272908;16834468;278.347.685.185.185
RadAd/WebIntents;au.radsoft.webintents;G;23;1413336258;1430186741;16850483;278.612.483.465.608
DrKein/StayOn;kein.stayon;G;23;1471919657;1491367397;19447740;321.556.547.619.048
LedgerHQ/bolos-tee;com.ledger.wallet.bootstrap;G;23;1456828373;1483918636;27090263;44.792.101.521.164
tom-dignan/android-opencnam-library;com.tomdignan.android.LEDCallerID;G;23;1334007636;1362143552;28135916;465.210.251.322.751
kjparkdavid/lolpingchecker;com.snowrain.lolpingchecker;G;23;1416696124;1450538227;33842103;559.558.581.349.206
kamilszewczyk/Aero2Captcha;ks.aero2captcha.app;G;23;1397643486;1432937540;35294054;583.565.707.671.958
realm01/DHCPv6-Client-Android;org.daduke.realmar.dhcpv6client;G;23;1442919233;1481551697;38632464;638.764.285.714.286
imherolddev/DailyLogKeeper;com.imherolddev.dailylogkeeper;G;23;1406999060;1445638133;38639073;638.873.561.507.937
lwwhb/SuperLife;com.wanax.superlife;G;23;1418384235;1459342486;40958251;677.219.758.597.884
SergioAyala/PSU-Facsimiles;com.ayala.sergio.uno;G;23;1451136577;1493321706;42185129;697.505.439.814.815
boxhead201/MorseLullabies;com.boxhead.android.morselullabies;G;23;1441590811;1485924438;44333627;733.029.546.957.672
liueugene/Picmapper;com.litesplash.picmapper;G;23;1435719994;1483239150;47519156;785.700.330.687.831
torcellite/imageComparator;com.torcellite.whatsappduplicatemediaremover;G;23;1364126482;1413093671;48967189;80.964.267.526.455
rickfluck/androidaq;com.androidaq&amp;G;23;1418237352;1485969002;67731650;111.990.162.037.037
chrisju/comiz;gmail.mchrisju.comiz;G;23;1375894113;1451828920;75934807;125.553.583.002.645
kiddoware/kidsplace-api-samples;com.kiddoware.kidsplace;G;23;1336948231;1428641165;91692934;151.608.687.169.312
nicolas-raoul/OxygenGuide-Android;orghub.OxygenGuide;F;23;1358250570;1460631088;102380518;169.279.957.010.582
lancewf/AirvoiceWidget;com.finfrock.airvoicewidget;G;23;1366557150;1477518949;110961799;183.468.583.002.646
blundell/RealBeauty;com.realbeauty.allie;G;24;1363697689;1368892217;5194528;858.883.597.883.598
lararufflecoles/StrollCharlton;es.rufflecol.lara.strollcharlton;G;24;1448449612;1453669725;5220113;863.113.921.957.672
alexmlong/Pashword;com.pashword;G;24;1439959696;1446742015;6782319;112.141.517.857.143
daisuke-nomura/lttimer;jp.nomula.pronama.lttimer&amp;G;24;1388857215;1396759082;7901867;130.652.562.830.688
zakallen/Barlift-Android;com.barliftapp.barlift&amp;G;24;1421435591;1433864812;12429221;205.509.606.481.481
andrewromanenco/git.android;com.romanenco.gitt;G;24;1371693942;1386024867;14330925;236.953.125
AflahB/labyrinth-of-before;com.mongooseofbefore.Labyrinth_of_Before&amp;G;24;1419868085;1439375438;19507353;322.542.212.301.587
boygaggoo/umra-guide;com.alumraguide.umra&amp;G;24;1342878013;1365251732;22373719;369.935.830.026.455
AlejandroMoran/MemeGenerator;com.alejandromoran.memegenerator&amp;G;24;1462025830;1486682937;24657107;407.690.261.243.386
nhphung216/news-droid;social.com.paper;G;24;1442596794;1469939729;27342935;452.098.792.989.418
MitchZinck/BlockJump;com.mzinck.blockjump.android;G;24;1413675045;1445539779;31864734;526.863.988.095.238
foxish/timeManager;com.anirudhr.timeMan;G;24;1356374978;1396602615;40227637;665.139.500.661.376
nwertzberger/soundheap;com.ideaheap.sound;G;24;1349825044;1390429020;40603976;671.362.037.037.037
jmavis/BoxedMeeting;com.JaredMavis.boxedmeeting;G;24;1372387762;1414122220;41734458;690.053.869.047.619
The1andONLYdave/open-authenticator;com.dlka.android.apps.authenticator2;G;24;1389959619;1442670704;52711085;871.545.717.592.593
mridang/dashclock-wifiinfo;com.mridang.wifiinfo;F;24;1365152762;1433786738;68633976;113.482.103.174.603
aniket91/TicTacToe;com.osfg.tictactoe;G;24;1382465814;1460790280;78324466;129.504.738.756.614
prrt714/Kaleidoscope;vnd.blueararat.kaleidoscope6;G;24;1335787935;1461479959;125692024;207.824.113.756.614
jiro-aqua/aGrep;jp.sblo.pandora.aGrep;F;24;1284206615;1414977664;130771049;21.622.197.255.291
asozyurt/universalistDergiRc;com.harweast.universalistDergi;G;25;1488139965;1493151851;5011886;828.684.854.497.354
pierreSquared/SquareRunner;adrians.simpleandroidgdf;G;25;1454848000;1459978395;5130395;848.279.596.560.847
ghunkins/SoundRecorder-master;com.danielkim.soundrecorder;G;25;1419464122;1425863171;6399049;105.804.381.613.757
ankurkhemani/DailyLaws;com.mindgames.dailylaw;G;25;1435015363;1446788142;11772779;194.655.737.433.862
goodkode/RegExGen;net.takoli.regexgen;G;25;1387747029;1401668553;13921524;230.183.928.571.429
djdance/echolotfm;ru.echolotfm.fingerprint;G;25;1466938127;1482268855;15330728;253.484.259.259.259
nblumoe/volcanoreport;com.nbapps.volcanoreport;F;25;1306352817;1322728032;16375215;270.754.216.269.841
inthemainframe/mygame;com.watabou.pixeldungeon;G;25;1422105758;1443692162;21586404;356.918.055.555.556
Lorenzo1906/InstaRecover;com.urbanlegend.instarecover;G;25;1468687395;1492628931;23941536;39.585.873.015.873
Timmehs/WifiBook;com.tim.wifibook;G;25;1391459118;1419626895;28167777;465.737.053.571.429
i-kozlov/IncomingCallSound;com.baybaka.incomingcallsound;G;25;1460750014;1490634918;29884904;494.128.703.703.704
chrjsorg/WearSmoking;org.chrjs.wearsmoking;G;25;1405438663;1437681997;32243334;533.123.908.730.159
Ulman95/Converter;com.ulman.android.converter;G;25;1460558346;1492964616;32406270;535.817.956.349.206
pepperonas/AppRegistry;com.pepperonas.appregistry.showcase;G;25;1451828428;1490618657;38790229;641.372.833.994.709
PLhery/RocketLyon;com.micropole.android.tcl_mobile;G;25;1436805815;1479989417;43183602;714.014.583.333.333
Galakart/MajorDroid;ru.galakart.majordroid;G;25;1386005663;1435469065;49463402;817.847.255.291.005
nawrasg/Call-Notifier;fr.nawrasg.callnotifier;G;25;1437939535;1488918822;50979287;842.911.491.402.116
PuzzleboxIO/orbit-android;info.puzzlebox.orbit;G;25;1431067277;1488434823;57367546;948.537.466.931.217
cab404/TabunAuth;everypony.tabun.auth;G;25;1398037933;1462027219;63989286;105.802.390.873.016
lycying/c2d-engine;info.u250.digs;G;25;1393061124;1463572872;70511748;116.586.884.920.635
thamizha/android-tamilvisai;com.tamil.visai&amp;G;25;1291984840;1365849762;73864922;122.131.154.100.529
JoseGD/MonthCalendarWidget;com.josegd.monthcalwidget;G;25;1306783498;1380751336;73967838;122.301.319.444.444
rgksugan/chennaibusroutes.in;in.rgksugan.chennaibusroute;G;25;1336062978;1410806159;74743181;123.583.301.917.989
loveyu/ContactOFQQAvatar;net.loveyu.contactofqqavatar;G;25;1410275199;1491761500;81486301;134.732.640.542.328
MarcusCalidus/BudgetEnvelopes;com.marcuscalidus.budgetenvelopes&amp;G;25;1408969741;1493020077;84050336;138.972.116.402.116
ric03uec/cramit;com.dev.cramit&amp;G;25;1313394591;1422842821;109448230;180.965.988.756.614
Tapojit/HampHack_Android_App;com.hampshire.tapojit.hamphack;G;26;1487763857;1493074731;5310874;878.120.701.058.201
cloudbearings/clienda;com.arturobermejo.clienda;G;26;1398631856;1405354726;6722870;111.158.564.814.815
HugoZhang33/HT2015;edu.pitt.is.HT2015;G;26;1434400064;1442506434;8106370;134.033.895.502.646
kanakamedala-rajesh/JsonParser-Test;com.venkatasudha.rajesh.jsonparsertest;G;26;1469721961;1478141801;8419840;139.216.931.216.931
rice0102/react-native-talkmap;com.talk_map;G;26;1481523436;1490022584;8499148;140.528.240.740.741
muojp/smsproxy;jp.muo.smsproxy;G;26;1351419705;1360558750;9139045;151.108.548.280.423
xresco/CircularLayout;com.omvana.mixer;G;26;1414907516;1426326254;11418738;188.801.884.920.635
yenvanio/Hackers-Calendar;com.shiv.hackerscalendar;G;26;1472652366;1484851305;12198939;201.702.033.730.159
Taremeh/apphovenAlpha;com.apphoven.apphovenAlpha;G;26;1478348471;1492985622;14637151;242.016.385.582.011
ezibyte/EziSocialDemo;com.ezibyte.ezisocialdemoapp;G;26;1366538881;1381701769;15162888;250.709.126.984.127
Darkhost/OnamHighSch;darkhost.onamhighsch;G;26;1457744810;1476801806;19056996;315.095.833.333.333
yifanfwu/ProximityLock;com.yifanfwu.proximitylock&amp;G;26;1439952803;1463258761;23305958;385.349.834.656.085
pistatium/mahougen;com.appspot.pistatium.mahougen;G;26;1458821218;1483881511;25060293;414.356.696.428.571
jaenelleisidro/gradingsystemsample;androidtemplate.securitywizards.herobo.com.androidtemplate;G;26;1431699733;1457892266;26192533;433.077.595.899.471
tjmolinski/crushr;com.tjm.crushr;G;26;1411442013;1439255794;27813781;45.988.394.510.582
arikfr/rocketalert-android;me.rocketalert.rocketalert;G;26;1405245082;1435936474;30691392;507.463.492.063.492
iRYO400/RandomStep;com.r400.ultra.free.rwallpapers;G;26;1436433805;1471273610;34839805;576.054.976.851.852
gregko/EbookConverter;com.hyperionics.avar;G;26;1456869025;1492030283;35161258;581.370.006.613.757
amithub/Screen-Lock-PI;com.pilockerstable;G;26;1407522771;1446169580;38646809;639.001.471.560.847
badoualy/manga-rush;com.mangarush.android;G;26;1401470955;1453733272;52262317;864.125.611.772.487
ninton/ShuffleNavi;jp.co.ninton.shufflenavi;G;26;1437324123;1490261327;52937204;875.284.457.671.958
fsauter/mensa-furtwangen;de.hfu.mensa;G;26;1358594626;1411732645;53138019;878.604.811.507.936
mattgmg1990/miracast-widget;com.mattgmg.miracastwidget;G;26;1388358763;1459750312;71391549;11.804.158.234.127
kahigiso/TheRwandaFocus;com.rwanda.focus;G;26;1384202430;1490319414;106116984;175.457.976.190.476
mrjoelkemp/Andrepl-The-Giant;com.mrjoelkemp.andrepl&amp;G;27;1381589177;1386441803;4852626;802.352.182.539.683
lukasks/smogify;com.lukasks.ukasz.smogify;G;27;1488207472;1493197502;4990030;825.071.097.883.598
dklaputa/BelecoLiveWallpaper;com.mylaputa.beleco;G;27;1484835359;1490614336;5778977;955.518.683.862.434
soduor/World-Countries;com.omondi.stephen.worldcountries;G;27;1478046039;1484870451;6824412;1.128.375
onionApps/Fire.onion;onion.fire;G;27;1452424838;1459302648;6877810;113.720.403.439.153
JoseExposito/FlingSolver;com.eggsoftware.flingsolver;G;27;1374840025;1382026303;7186278;118.820.734.126.984
abcodeworks/ShareFile-Android;com.abcodeworks.sharefileapp;G;27;1416726268;1424474896;7748628;128.118.849.206.349
micklinISgood/linkus;tw.plash.linkusv1;G;27;1473390777;1482286414;8895637;14.708.394.510.582
bodhish/CORTEX;com.eightstags.cortexnew;G;27;1472315958;1485719336;13403378;22.161.669.973.545
wburhan2/PhysicsFormulae;com.physicsformulae.app;G;27;1400562157;1414725199;14163042;234.177.281.746.032
gilvitzi/UAVLogbook;com.gilvitzi.uavlogbookpro;G;27;1453325438;1468581596;15256158;25.225.128.968.254
teejayc/VIVID-Flashcards;com.fstprj.teejayc.vividcard;G;27;1457094724;1474157063;17062339;282.115.393.518.519
devmil/parrot-zik-2-supercharge;com.parrot.zik2;G;27;1430768485;1450303460;19534975;32.299.892.526.455
AfterRabbleApps/Chapocalypse;com.afterrabble.chapocalypse;G;27;1456810785;1477017830;20207045;334.111.193.783.069
OmarMohamedDev/SocialLives;omar.mohamed.socialphotoneighbour;G;27;1453375944;1479689482;26313538;43.507.833.994.709
jimandreas/PopularMovies;com.jimandreas.popularmovies;G;27;1453029444;1479403935;26374491;436.086.160.714.286
velazcod/wear-display-brightness;com.danvelazco.wear.displaybrightness;G;27;1406486739;1433749551;27262812;450.774.007.936.508
horvste/EasyWebPageDownloadForAndroid;org.fortschools.app;G;27;1395274218;1426807854;31533636;521.389.484.126.984
zhengkm/AIEDxEDM2015;pitt.edu.AIEDxEDM2015;G;27;1434425502;1466454303;32028801;529.576.736.111.111
micdm/no-bad-habits;com.micdm.nobadhabits;G;27;1410972612;1444291518;33318906;550.907.837.301.587
vikzter/Poink;com.coromandel.poink&amp;G;27;1405702882;1441717632;36014750;595.481.977.513.228
RadioHopeUA/Android-HopeFM;ua.hope.radio.hopefm;G;27;1452865523;1490579359;37713836;623.575.330.687.831
hrk/androidTileMapEditor;it.sineo.android.tileMapEditor;G;27;1330246993;1392989375;62742382;103.740.710.978.836
JoostvDoorn/GlutenVrijApp;com.joostvdoorn.glutenvrij;G;27;1421532624;1486400371;64867747;107.254.872.685.185
AJ92/HwInfoReceiver;com.threedevs.aj.HwInfoReceiver;G;27;1406235518;1487363375;81127857;134.139.975.198.413
ciubex/tkconfig;ro.ciubex.tkconfig;G;27;1374974845;1488874807;113899962;188.326.656.746.032
cclo7/incafe;com.cclo7.android.incafe&amp;G;28;1457314040;1463121703;5807663;960.261.739.417.989
Ekvi/HowToSayIt;com.ekvilan.howtosayit;G;28;1430756264;1440513937;9757673;161.337.185.846.561
animeshjn/braininjury;com.kihdapps.brain_injury;G;28;1479414093;1490033842;10619749;175.591.087.962.963
dmitriy-deomin/Aimpradioplalist;dmitriy.deomin.aimpradioplalist;G;28;1481405716;1492930403;11524687;190.553.687.169.312
everton-rosario/android;br.com.uol.ps.wallet;G;28;1410541427;1422984546;12443119;205.739.401.455.026
iamtrk/Device-Explorer;com.iamtrk.androidexplorer;F;28;1474275208;1487328317;13053109;21.582.521.494.709
Jimmar/xkcd-xD;jimmar.net.xkcdxd;G;28;1420486745;1435699487;15212742;251.533.432.539.683
nirhart/ParallaxScroll;com.nirhart.parallaxscrollexample;G;28;1394292822;1414266736;19973914;330.256.514.550.265
vottakvot/ColorPlayer;ru.testsimpleapps.coloraudioplayer;G;28;1469386486;1492974842;23588356;390.019.113.756.614
tonytamsf/android-HowToTip;com.tonytam.howtotip;G;28;1370034822;1408769965;38735143;640.462.020.502.646
feathertw/HappyWifi;tw.tools.ncku.wifi;G;28;1359171011;1398000856;38829845;642.027.860.449.735
mehmetakiftutuncu/quupNotificationsAndroid;com.mehmetakiftutuncu.quupnotifications;G;28;1431591903;1470908119;39316216;650.069.708.994.709
jufabeck2202/IonicFlashcards;com.ionicframework.flashcards228577&amp;G;28;1448731438;1490636927;41905489;692.881.762.566.138
beoreoji/quickMemo-for-Android;com.manickids.quickmemo;G;28;1447679474;1490542961;42863487;708.721.676.587.302
bartoleo/cubi;com.bartoleo.cubi;G;28;1411559888;1454925947;43366059;717.031.398.809.524
cgrebeld/lcbohelper;com.tinystranger.lcbohelper.app&amp;G;28;1401154818;1444607509;43452691;718.463.806.216.931
ilyaev/deject;pbartz.games.deject;G;28;1394663411;1443133421;48470010;801.422.123.015.873
Rambou/Andro-SecHeaders;gr.rambou.secheader;G;28;1425743555;1479810904;54067349;893.970.717.592.593
LeoLogeart/PodcastDownloader;com.dl.podcastgrossestetes;G;28;1413036279;1472389425;59353146;981.368.154.761.905
fernandomantoan/android-latinoware;com.fernandomantoan.latinoware;G;28;1348060028;1444949473;96889445;160.200.801.917.989
rdanielmurphy/FundFind;app.sbaloan;G;28;1320980417;1444888770;123908353;20.487.492.228.836
obonal/droidtracker;cauchy.android.tracker;G;28;1241047646;1439841766;198794120;328.693.981.481.482
ac-opensource/Matchmaking-App;com.youniversals.playupgo;G;29;1486446531;1493184554;6738023;111.409.110.449.735
Peleus1992/Lost_and_Found_Android_app;edu.gatech.wguo64.lostandfoundandroidapp;G;29;1451670039;1458617215;6947176;114.867.328.042.328
abcodeworks/WebShortcut-Android;com.abcodeworks.webshortcutapp;G;29;1416802060;1424518046;7715986;127.579.133.597.884
bychok300/SimpleParser;com.anton.src.simpleparser_android;G;29;1479644777;1487679996;8035219;132.857.457.010.582
YounghoCho/SuwonTalkTalk;com.jointree.suwontalktalk;G;29;1481569832;1490248042;8678210;143.488.921.957.672
charlieCollins/embiggen;com.totsp.embiggen;G;29;1350344547;1361455852;11111305;183.718.667.328.042
abhyudayasrinet/Earth-Savior;com.ggwp.earthsavior;G;29;1449955257;1465762610;15807353;261.364.963.624.339
erichlotto/ShowShow;com.erichlotto.showshow;G;29;1417919380;1439324454;21405074;353.919.874.338.624
felipeaugusto1/Rio-Saude;riomaissaude.felipe.com.br.riosaude;G;29;1443140204;1484700499;41560295;687.174.189.814.815
WilixLead/iWownController;ru.wilix.device.geekbracelet;G;29;1442426682;1487406274;44979592;743.710.185.185.185
razem-io/BittyDream;com.bitty.bittydream;G;29;1394092022;1466704359;72612337;120.060.081.018.519
shaubert/android-dirty-wall;com.shaubert.dirty;G;29;1344873262;1422231144;77357882;127.906.550.925.926
ZorgeR/nanoConverter;com.nanoconverter.zlab;F;29;1333017739;1427322202;94304463;155.926.691.468.254
montecode/swipe-box;me.montecode.games.swipeball.android;G;30;1416648950;1421666922;5017972;829.691.137.566.138
dretta/MineSweeper;com.daniel.minesweeper;G;30;1418722311;1424564353;5842042;965.946.097.883.598
AlekseyMak/QuizApp;com.almadev.znaniesila;G;30;1443366259;1449266957;5900698;975.644.510.582.011
AlexBHarley/omi_Android;com.alexharley.omi;G;30;1431261875;1437736765;6474890;107.058.366.402.116
ww24/pattern;jp.ww24.handwrites;G;30;1446667829;1453275639;6607810;109.256.117.724.868
AndruByrne/Rezzo;com.andrubyrne.rezzo;G;30;1374891766;1381673441;6781675;112.130.869.708.995
TimothySanchirico/LocationAlarm;com.timothy.greg.locationalarm;G;30;1433880819;1442485456;8604637;142.272.437.169.312
quicknotes/NetLive;com.richardlucasapps.netlive&amp;G;30;1383834467;1393952274;10117807;167.291.782.407.407
L3xer/MarsCitizens;com.axsoray.marscitizens;G;30;1478505349;1489610114;11104765;183.610.532.407.407
applh/lightbike2;com.applh.lightbike2;G;30;1365433306;1376574247;11140941;184.208.680.555.556
wisedog/WhoochooAdvSms;net.wisedog.android.whooing.advsms;G;30;1388894506;1400728609;11834103;195.669.692.460.317
ethwillz/EaseofUse;com.ethwillz.ethan.easeofuse&amp;G;30;1469139706;1486527463;17387757;287.495.982.142.857
mikljohansson/recall;se.embargo.recall;G;30;1419163358;1436638213;17474855;28.893.609.457.672
arnyigor/flightlogbook;com.arny.flightlogbook;G;30;1463239242;1491242069;28002827;463.009.705.687.831
felipesm/ManualSQL;com.felipe.manualsql;G;30;1461122704;1490937581;29814877;492.970.849.867.725
ajkh35/AnimationsInAndroid;com.myapp.ajay.animationsinandroid;G;30;1455526636;1493149897;37623261;622.077.728.174.603
gitesdewallonie/alloch.android;be.gitesdewallonie.allochambredhotes;G;30;1384765420;1426671073;41905653;692.884.474.206.349
jorgimello/TercodaMisericordia;mej.jorge.com.tercodamisericordia;G;30;1446662858;1490708647;44045789;728.270.320.767.196
tananaev/traccar-manager-android;org.traccar.manager;F;30;1441167434;1490782124;49614690;82.034.871.031.746
PIsberg/spotify-streamer;isberg.udacity.spotifystreamer;G;30;1436811924;1487613705;50801781;839.976.537.698.413
dhiegoatencio/Unity3d-Numbers;com.dongames.getnumbers;G;30;1424494076;1477414597;52920521;875.008.614.417.989
jesperancinha/ping-app-android;com.steelzack.ping&amp;G;30;1395038440;1452983192;57944752;958.081.216.931.217
josuebasurto/Garitas-Tijuana;com.garitas.tijuana;G;30;1346862571;1482156810;135294239;223.700.791.997.354
gvellut/MapAlarmist;com.vellut.geoalarm;G;31;1384516974;1390661871;6144897;101.602.132.936.508
mozadeh/smartmail;com.smartikyapps.smartmail;G;31;1487119948;1493772317;6652369;109.992.873.677.249
dainiuss/FriendLocator;me.dainius.friendlocator;G;31;1412572467;1419235320;6662853;110.166.220.238.095
jalvaro/LivetvLinks;com.jalvaro.livetvlinks;G;31;1475791006;1486417135;10626129;175.696.577.380.952
sndurkin/notification-check;com.sndurkin.notificationcheck;G;31;1382588148;1394427202;11839054;195.751.554.232.804
manero/MultasSociaisAndroid;net.multassociais.mobile;G;31;1341004220;1359857916;18853696;311.734.391.534.392
gpetuhov/CirclePop;com.gpetuhov.android.circlepop;G;31;1463745761;1485443487;21697726;358.758.697.089.947
subprogram/ParanoidSmsBlocker;ru.subprogram.paranoidsmsblocker;G;31;1416676179;1438525529;21849350;361.265.707.671.958
androidseb/camerarestarter;com.exlyo.camerarestarter;G;31;1459859776;1482486413;22626637;37.411.767.526.455
rjmarsan/Pixelesque;com.rj.pixelesque;F;31;1316067238;1341348534;25281296;418.010.846.560.847
mcfasa09/bbcmicro;com.littlefluffytoys.beebdroid;G;31;1391611787;1420209569;28597782;472.846.924.603.175
velazcod/android-wear-emergency-alert;com.danvelazco.android.wear.emergencyalert;G;31;1404363277;1433742425;29379148;485.766.335.978.836
Nintynien/NowPlaying;com.skylerbock.nowplaying;G;31;1449989920;1480219147;30229227;499.821.875
jerickson314/sdscanner;com.gmail.jerickson314.sdscanner;F;31;1385765034;1423935847;38170813;631.131.167.328.042
acbelter/DirectionalCarousel;com.acbelter.directionalcarouseldemo;G;31;1399158706;1459981752;60823046;100.567.205.687.831
TriggerHappyRemote/TriggerHappyRemote-Android;com.triggerhappy.android;G;31;1337837915;1399162189;61324274;101.395.955.687.831
ilyaev/snake;pbartz.games.snake;G;31;1363472202;1443133350;79661148;131.714.861.111.111
alinmindroc/Mood-Player;ncit.opencv.samples.facedetect;G;31;1372507293;1452771262;80263969;132.711.588.955.026
wrr/speech_trainer;mixedbit.speechtrainer;G;31;1320779847;1487692969;166913122;275.980.691.137.566
TedHoryczun/Goals;com.goals.ted.goals&amp;G;32;1469064615;1474995854;5931239;980.694.279.100.529
Urucas/Legofy;com.urucas.legofy;G;32;1447697666;1455398954;7701288;127.336.111.111.111
matejdro/WearVibrationCenter;com.matejdro.wearvibrationcenter;G;32;1485072495;1493713008;8640513;142.865.625
shiami/AndroidTaigiDict;com.taccotap.taigidict;G;32;1477474769;1490350067;12875298;212.885.218.253.968
SethuVignesh/KanthaPuranam-SalemRukmani;com.newtra.salemrukmani&amp;G;32;1461069937;1478267591;17197654;284.352.744.708.995
Conorbro/Biology-MCQ-Android-Application;com.cb.leavingcertbiologyquiz;G;32;1405255979;1424883424;19627445;324.527.860.449.735
Fleker/SmartNetworking;org.rowanieee.smartnetworking;G;32;1461983347;1485751681;23768334;39.299.494.047.619
stefanosiano/Wavy-Fish;com.stefanosiano.wavyfish.android;G;32;1448388800;1474717395;26328595;435.327.298.280.423
mehmetakiftutuncu/eshotroid-legacy;com.mehmetakiftutuncu.eshotroid;G;32;1362873468;1390417786;27544318;455.428.538.359.788
sebastiansokolowski/SecureSMS;com.securesms;G;32;1436114419;1465568864;29454445;487.011.326.058.201
berrnd/Time-Recording-Auto-Export-Tasker-Plugin;de.berrnd.Time_Recording_Auto_Export_Tasker_Plugin;G;32;1396546757;1430484414;33937657;561.138.508.597.884
lukecaptaincode/DiceRoller;com.lukecaptaincode.diceroller&amp;G;32;1436911897;1473412650;36500753;603.517.741.402.116
pfn/advanced-keyguard-manager;com.hanhuy.android.bluetooth.keyguard;G;32;1374805026;1418670741;43865715;725.292.906.746.032
lindolsang/My-Cashbook;kr.lindol.mycashbook;G;32;1408892092;1455458226;46566134;769.942.691.798.942
chiuki/friendspell;com.sqisland.friendspell;G;32;1440389739;1489000585;48610846;803.750.760.582.011
manimaul/MX-Tides;com.mxmariner.tides;F;32;1369864892;1428778118;58913226;974.094.345.238.095
atmoresume-test/QuickDialer;ru.jdev.qd;G;32;1327146137;1399956362;72810225;120.387.276.785.714
maximbilan/cpp_marmalade_sdk_the_pursuit_3d;com.maxim.thepursuitdemo;G;32;1396382804;1481121303;84738499;140.109.952.050.265
offbye/ChinaTVGuide;com.offbye.chinatvguide;G;32;1313251162;1431743249;118492087;195.919.456.018.519
edwardharks/Aircraft-Recognition;com.edwardharker.aircraftrecognition;G;33;1487505054;1492960731;5455677;902.062.996.031.746
jimandreas/cheesesquare-LeakCanary-sandbox;com.jimandreas.android.designlibdemo&amp;G;33;1473746203;1479449700;5703497;943.038.525.132.275
newns92/SimpleTip;com.nimz.android.splitTip&amp;G;33;1473458251;1479483373;6025122;996.217.261.904.762
lolevsky/Android-Clean-Architecture;me.lolevsky.nasaplanetary;G;33;1468219099;1475321924;7102825;117.440.889.550.265
dhurley/Stranded-In-Space;net.djhurley.strandedinspace.android;G;33;1424283237;1432288738;8005501;132.366.087.962.963
DiogoMiranda/PertApp;diogo.miranda.pert;G;33;1479818960;1491184678;11365718;187.925.231.481.481
gossiks/Timelike;org.kazin.timelike;G;33;1434982372;1447181765;12199393;201.709.540.343.915
larruda/ciandt-tt;com.ciandt.tt;G;33;1391740753;1407206250;15465497;255.712.582.671.958
apelsoczi/NFCAlarm;com.pelsoczi.adam.tapthat;G;33;1453177254;1468793385;15616131;258.203.224.206.349
wburhan2/SpendingTracker;com.spendingtracker.app;G;33;1398888637;1414725468;15836831;261.852.364.417.989
rokzin/converto;com.rokzin.converto;G;33;1371178612;1395334579;24155967;399.404.216.269.841
vvkirillov/simple-android-CPU-usage-viewer;com.nr.cpu.usage.viewer;G;33;1432564206;1460231982;27667776;457.469.841.269.841
kaytat/SimpleProtocolPlayer;com.kaytat.simpleprotocolplayer&amp;G;33;1445059196;1477783561;32724365;541.077.463.624.339
isjeffcom/LiveFACE_LAUNCHER-OSP;cc.flydev.face;G;33;1454208028;1488790644;34582616;571.802.513.227.513
ikew0ng/Dribbo;com.refactech.driibo;F;33;1374122321;1408798264;34675943;573.345.618.386.243
feelinglucky/Presentation;com.gracecode.android.presentation;G;33;1384320865;1419563771;35242906;582.720.006.613.757
mkAndroDev/SlubJuzZa;com.krawczyk.maciej.slubjuzza&amp;G;33;1444237480;1480266135;36028655;595.711.888.227.513
antoinedelia/Jeux-d-alcool;com.antoinedelia.lebarbu_versionalcool;G;33;1452969076;1493383665;40414589;668.230.638.227.513
tjmolinski/fuzzy-curro;com.tjm.rpr;G;33;1366478758;1414370341;47891583;79.185.818.452.381
gorjanz/numbers-game;com.ngame;G;33;1398852488;1460204539;61352051;101.441.883.267.196
DatumDroid/DatumDroid;com.datumdroid.app;G;33;1320774019;1388407839;67633820;111.828.406.084.656
blitzmohit/guidance-app;org.geek90.guidance;G;33;1353950983;1442847760;88896777;146.985.411.706.349
dahlia/muzei-pixiv;com.pixiv.muzei.pixivsource;G;33;1393811508;1493585516;99774008;164.970.251.322.751
arnef/bewegungsmelder-android;de.arnefeil.bewegungsmelder;F;33;1382649957;1489096998;106447041;176.003.705.357.143
poliva/rootadb;org.eslack.rootadb;G;33;1364988217;1479315578;114327361;189.033.334.986.772
JoffreyLGT/MySteamGames;com.joffreylagut.mysteamgames.mysteamgames;G;34;1486559955;1491829023;5269068;871.208.333.333.333
calren/Android_EatNow;com.caren.eatnow;G;34;1411287402;1416724539;5437137;89.899.751.984.127
vikasawadhiya/Flashlight;vikasawadhiya.projects.flashlight;G;34;1474519242;1482472152;7952910;131.496.527.777.778
Vinisoft/Face-Recognition-SDK-for-Android;com.vinisoft.facesdk.demo;G;34;1409556866;1418348087;8791221;145.357.490.079.365
WangDaYeeeeee/GeometricWeather;wangdaye.com.geometricweather;G;34;1481461375;1493548647;12087272;199.855.687.830.688
TranBrian10/WeightedCalculator;com.syfenworks.weightedcalculator&amp;G;34;1439575066;1452046182;12471116;206.202.314.814.815
smilyo/Smilyo-Beta--Android;com.smilyo.main;G;34;1416155257;1430680698;14525441;240.169.328.703.704
dcjosej/JustSketch;com.tfg.android;G;34;1421602480;1438693461;17090981;282.588.971.560.847
AliMehrpour/ClipBox;com.volcano.clipbox;G;34;1429601235;1448045055;18443820;304.957.341.269.841
patcon/writeily;com.jmartin.writeily;G;34;1398440381;1418314982;19874601;32.861.443.452.381
trakos/iron-clouds;pl.trakos.ironClouds.android;G;34;1384058557;1407867214;23808657;393.661.656.746.032
robzerg/chordtransposer-android;de.chillercode.chordtransposer;G;34;1367014756;1394668174;27653418;45.723.244.047.619
gatt-ip/gatt-ip-app;org.gatt_ip.activity;G;34;1417569852;1471546440;53976588;89.247.003.968.254
dhiegoatencio/Lista-de-Compras_Android;com.dhiegoatencio.listadecompra;G;34;1430498850;1489277990;58779140;971.877.314.814.815
DSteve595/EmojiSwitcher;com.stevenschoen.emojiswitcher;G;34;1405266307;1477402683;72136376;119.273.108.465.608
tbarbette/grignouxcinema;be.itstudents.tom.android.cinema;G;34;1382280973;1455187506;72906533;120.546.516.203.704
MarcBernstein/Every-Word-Helper;com.mcbtech.everywordhelper;G;34;1304480118;1409118353;104638235;173.012.954.695.767
pebbe/AndroidVrKubus;nl.xs4all.pebbe.vrkubus;G;35;1483018917;1487933667;4914750;812.624.007.936.508
emgreen33/AlertaBLE;com.ionicframework.alertable509848;G;35;1484609285;1489810115;5200830;859.925.595.238.095
zeromaro/WorDK;dingdiling.wordk;G;35;1449088371;1454650508;5562137;919.665.509.259.259
tagantroy/Notes;com.tagantroy.notes;G;35;1407697034;1414278236;6581202;108.816.170.634.921
vladbakalo/SharePhoto;com.sharephoto;G;35;1485179406;1492619638;7440232;123.019.708.994.709
tungsd/Metronome;com.tungnd.android.beautifulmetronome;G;35;1465444289;1473341621;7897332;130.577.579.365.079
cfan8/TGFC;com.linangran.tgfcapp;G;35;1419917809;1429857623;9939814;164.348.776.455.026
mclhrn/IrishBirds;com.mickhearne.irishbirds.birds;G;35;1397642463;1409351266;11708803;193.597.933.201.058
superapps/The-memo-awakens;com.giocode.thememoawakens;G;35;1451313661;1463472116;12158455;20.103.265.542.328
sidneynguyen/Jawn;com.carnagestudios.projectjawn;G;35;1452731835;1466388603;13656768;225.806.349.206.349
soboapps/AIOhfark;com.soboapps.ohfark;G;35;1440634262;1456487427;15853165;262.122.437.169.312
ANURAGX/File_Quest;org.anurag.file.quest;G;35;1425149736;1445891378;20741642;34.295.042.989.418
Athou/commafeed-newsplus;com.commafeed.newsplus;G;35;1375972008;1410583568;34611560;572.281.084.656.085
ftlno/MuteMate;li.ftl.mutemate;G;35;1358716575;1394551552;35834977;592.509.540.343.915
AntonioRedondo/GrabSomeFood-Test;com.foodittest;G;35;1417106562;1453299247;36192685;598.424.024.470.899
richardbw/tyshler_footdisco;com.barneswebb.android.tyshlerfootdisco;G;35;1451912113;1490352549;38440436;63.558.921.957.672
yacob89/7MinutesWithTheLord;com.gerejadibandung.minuteswiththelord;G;35;1396117298;1451649830;55532532;918.196.626.984.127
chenjishi/luckymoney;com.miscell.wechat.lucky&amp;G;35;1423748695;1493173026;69424331;11.478.890.707.672
prellele/shoppinglist-android;de.shoppinglist.android;G;35;1345645700;1418559823;72914123;120.559.065.806.878
Pi-Developers/Socials-Addict;pidevs.socialsaddict;G;35;1407518840;1486936409;79417569;131.312.118.055.556
ciubex/storage-info;ro.ciubex.storageinfo;G;35;1387065952;1469352688;82286736;136.056.111.111.111
bradgearon/pfudor;wds.pink.fluffy;G;35;1390885453;1479251234;88365781;14.610.744.212.963
nelenkov/cryptfs-password-manager;org.nick.cryptfs.passwdmanager;G;35;1343830811;1460906260;117075449;193.577.131.283.069
tel3342311/DVR_IView_eclipse;com.tk.android.simplemjpeg;G;35;1350445114;1493789938;143344824;237.011.944.444.444
michael-wang/tatala;com.studioirregular.bonniesbrunch;G;36;1345434788;1352444446;7009658;11.590.042.989.418
vssnake/FithleticsInterval;vssnake.intervaltraining;G;36;1404675933;1414149705;9473772;156.643.055.555.556
farhanarnob/Calculator;com.udahoron.arnob.calculator;G;36;1475578230;1489316242;13738012;227.149.669.312.169
lanhuanze/imdriving;com.irefire.android.imdrivingfree;G;36;1403653900;1419817128;16163228;26.724.914.021.164
rafasalas/Radiolaria;com.rafasalas.mandala;G;36;1460117115;1476793371;16676256;275.731.746.031.746
hatak30/Benefit_mvvm;com.hatak.benefit;G;36;1472748211;1491768622;19020411;314.490.922.619.048
Rafagf/CountriesMVP;com.countries.countriesoftheworld;G;36;1447498076;1467756843;20258767;334.966.385.582.011
HeikkiDev/osport-hello;com.proyecto.enrique.osporthello;G;36;1458174288;1483718740;25544452;422.361.970.899.471
baluubas/XBMC-Widget;com.anderspersson.xbmcwidget;F;36;1319053697;1350217024;31163327;515.266.650.132.275
mediavrog/integrated-rating-request;net.mediavrog.samples.irr;G;36;1453794059;1485099181;31305122;517.611.144.179.894
sultan-mirza/TrackAll;in.kuari.trackall&amp;G;36;1453149639;1488468357;35318718;583.973.511.904.762
abhinav4192/Barron-s-1100;fightingpit.barrons1100;G;36;1444326295;1483123320;38797025;641.485.201.719.577
haridas/creditpay;in.haridas.creditpay;G;36;1449249789;1488686998;39437209;65.207.025.462.963
ganlaw/Gradeulator;com.gannon.gradulator;G;36;1412089513;1453948245;41858732;692.108.664.021.164
Simsso/GSWN-Stupla;com.timodenk.gswnstupla;G;36;1447584244;1493903121;46318877;765.854.447.751.323
ng-b0ne/HatebuView;me.b0ne.android.hatebuview;G;36;1379258227;1426149445;46891218;775.317.757.936.508
tommy6073/BookQuotes;com.tommy6073.bookquotes;G;36;1413277523;1467612682;54335159;898.398.792.989.418
RobertoArtiles/KittenGIFs;com.the_roberto.kittengifs;G;36;1428266639;1490970409;62703770;103.676.868.386.243
andrewflynn/bettersettlers;com.nut.bettersettlers;G;36;1376144789;1457311308;81166519;134.203.900.462.963
smoradi/clocki;mars.clocki;G;36;1399724459;1482048375;82323916;136.117.585.978.836
fabienbk/jack-benoit;com.fbksoft.jb;G;36;1378882932;1477006213;98123281;162.240.874.669.312
ciubex/propeditor;ro.ciubex.propeditor;G;36;1367514652;1469993156;102478504;169.441.970.899.471
ldo/porter_duff_browser_android;nz.gen.geek_central.porter_duff_browser;G;36;1316420794;1468896521;152475727;252.109.336.970.899
auditio/MathAttack;org.auditio.game;G;37;1425536900;1430706255;5169355;854.721.395.502.646
daniel-kashin/BatyaMessagingApp;com.danielkashin.batyamessagingapp;G;37;1477236291;1482775802;5539511;915.924.437.830.688
LoicLWRT/FieldTracer;org.servalproject;G;37;1363256715;1371270947;8014232;13.251.044.973.545
Fibonacci-/DogecoinMonitor;com.helwigdev.a.dogecoinutilities;G;37;1423441583;1436549385;13107802;21.672.953.042.328
FBemf/macro-tracker;fbemf.macrotracker;G;37;1461897001;1485631846;23734845;392.441.220.238.095
chriskonstad/BruinLyfe-Java;com.bruinlyfe.bruinlyfe;G;37;1380946058;1409495796;28549738;472.052.546.296.296
semprebon/DroidDice2;com.droiddice&amp;G;37;1324907150;1353873405;28966255;478.939.401.455.026
mmnormyle/BraggingRights;io.matthew.braggingrights&amp;G;37;1418875116;1454401226;35526110;587.402.612.433.862
pranavpandey/small-app-support;com.pranavpandey.smallapp.stopwatch;G;37;1454406788;1493139559;38732771;640.422.800.925.926
JNVgames/Bounded;com.jnvgames.bounded.android;G;37;1440386777;1482565758;42178981;697.403.786.375.661
matthill/darwinwallet;com.ndu.mobile.darwinwallet;F;37;1350051506;1400424417;50372911;832.885.433.201.058
SidMorad/Wordpal;mars.wordpal;G;37;1406791225;1459675425;52884200;874.408.068.783.069
emergentdotorg/shaman;org.emergent.android.weave;F;37;1293870003;1350512739;56642736;936.553.174.603.175
jbruchanov/FastNote;com.scurab.android.idearecorder;G;37;1332763357;1391024239;58260882;963.308.234.126.984
mayconfsbrito/AcheProvas;com.acheprovas&amp;G;37;1379559914;1455641994;76082080;12.579.708.994.709
youten/KanJisyo;youten.redo.musuroom.kanjisyo&amp;G;37;1371912242;1487436405;115524163;191.012.174.272.487
wkillerud/hiofenigma-android;edu.killerud.kitchentimer;F;37;1328830532;1459027286;130196754;215.272.410.714.286
micku7zu/Locate-driver;com.micutu.locatedriver;G;38;1467306176;1473011129;5704953;943.279.265.873.016
namsor/gendreapp;com.namsor.api.samples.gendreapp;G;38;1395578282;1402353175;6774893;112.018.733.465.608
bbodin/slambench-android;project.pamela.slambench;G;38;1468575522;1475759979;7184457;118.790.625
LyricalMaestro/SoracomSampleApp;com.lyricaloriginal.soracomsampleapp&amp;G;38;1445158068;1454088476;8930408;147.658.862.433.862
arcbit/arcbit-android;com.arcbit.arcbit;G;38;1482214628;1491183941;8969313;148.302.132.936.508
SShayashi/NaniSyura;org.cocos2dx.SyuraApp;G;38;1453282484;1466271476;12988992;214.765.079.365.079
sairam1592/RoyalEnfieldFT;com.reft.admin.ridersdelight;G;38;1445308941;1461048630;15739689;260.246.180.555.556
santafebound/yeetclub-android;com.yeetclub.android&amp;G;38;1475485122;1491659017;16173895;267.425.512.566.138
NateLove/BT4Android-trunk;com.love.apps.BT4U;G;38;1346272514;1364443240;18170726;300.441.898.148.148
Rishabhk07/silent-phone-down;com.silentflip.hptouchsmart.phonedown&amp;G;38;1469521240;1487946386;18425146;304.648.578.042.328
AvielNiego/BluePal;com.avielniego.openhvr;G;38;1471515605;1491497496;19981891;330.388.409.391.534
antoniotari/reactive-ampache;com.antoniotari.reactiveampacheapp;F;38;1465759497;1493253194;27493697;454.591.550.925.926
lionleaf/Icarus;com.liongrid.icarus;G;38;1330100570;1370564938;40464368;669.053.703.703.704
rmceoin/cidrcalculator;us.lindanrandy.cidrcalculator;G;38;1403538276;1463789882;60251606;996.223.644.179.894
saeedzareian/PersianDarwinWallet;com.ndu.mobile.darwinwallet&amp;G;38;1350051506;1413486860;63435354;104.886.498.015.873
emilburzo/android-portabilitate;com.emilburzo.portabilitate;G;38;1402565172;1486454960;83889788;13.870.666.005.291
kshark27/UltraExplorer;com.ksharkapps.filebrowserlite;G;38;1364588902;1470620571;106031669;175.316.913.029.101
yukuku/passgen;yuku.infinitepassgen.app;G;38;1261476883;1402557539;141080656;23.326.828.042.328
aedwa038/Mangastream-notifier;com.manga.mangastreamnotifier;G;39;1398564455;1403830247;5265792;870.666.666.666.667
kvnxdev/NotifySC;com.notify.sc;G;39;1397841950;1403907334;6065384;100.287.433.862.434
jhesed/Random-Bible-Verse-Generator;com.jsos.randomverse2&amp;G;39;1478664785;1484731660;6066875;100.312.086.640.212
enricocid/Simply-Solid;com.enrico.earthquake;F;39;1477999669;1485098928;7099259;117.381.927.910.053
mslhii/findmepmt;com.kritikalerror.findmepmt;G;39;1407028769;1420185200;13156431;217.533.581.349.206
Devaprise/Targo-Tap;com.devaprise.targo_tap;G;39;1424029791;1437769313;13739522;227.174.636.243.386
kv1dr/slo-language-fixer;si.kv1dr.slolanguagefixer;G;39;1395349241;1413461230;18111989;299.470.717.592.593
predict-io/PredictIO-Android;io.predict.demo;G;39;1466673221;1489156141;22482920;371.741.402.116.402
klnvch/LinkFiveDots;by.klnvch.link5dots;G;39;1431709503;1471801940;40092437;662.904.050.925.926
misyobun/MSBVersionUpdater;misyobun.com.regardstoblackjack;G;39;1423905169;1491047072;67141903;111.015.051.256.614
vsamov/CrystalBall;com.vsamov.crystalball;G;39;1400534279;1472439545;71905266;118.890.982.142.857
justinodwyer/Beacon-Scanner-and-Logger;net.jmodwyer.ibeacon.ibeaconPoC;G;39;1394463197;1483526895;89063698;14.726.140.542.328
codeskraps/sBrowser;com.codeskraps.sbrowser;G;39;1330181891;1477507526;147325635;243.593.973.214.286
Antonis427/veterondo;com.saladdressing.veterondo;F;40;1459201400;1465198694;5997294;991.616.071.428.571
kyriog/rights-alert;fr.keuse.rightsalert;G;40;1335209653;1341244097;6034444;997.758.597.883.598
JW-Vinay/GifFeed;com.giffedup&amp;G;40;1443642929;1450300534;6657605;110.079.447.751.323
MojRoid/RAIN;moj.rain;G;40;1451158194;1458066070;6907876;114.217.526.455.026
Ekvi/ExchangeMarketClient;exchangemarket.ekvilan.com.exchangemarketclient;G;40;1433356874;1440513999;7157125;118.338.707.010.582
mikemilla/copyshare;com.mikemilla.copyshare;G;40;1461813382;1474173765;12360383;204.371.412.037.037
ianhenrydev/civ6info-Android;bitlads.civ6info;G;40;1466878681;1486082170;19203489;317.518.005.952.381
redlee90/6502-Emulator;com.redlee90.learn6502assembly;G;40;1409070884;1428609758;19538874;323.063.392.857.143
pl4za/Spotlight;com.pl4za.spotlight;G;40;1449924012;1475572103;25648091;424.075.578.703.704
davidschwegler/TICompanion;com.appenjoyment.ticompanion;G;40;1400395081;1427459266;27064185;447.489.831.349.206
Will1229/BestRoute;com.will.studio.bestroute&amp;G;40;1450452676;1478100266;27647590;457.136.078.042.328
abusuioc/black-screen-battery-saver;busu.blackscreenbatterysaver;G;40;1464441083;1492415979;27974896;462.547.883.597.884
worker8/Blue-unofficial-Imgur-reader;worker8.com.github.imgurblue;G;40;1452691984;1482481582;29789598;492.552.876.984.127
boxhead201/OpenWifiNetworks;com.boxhead.android.openwifinetworks;G;40;1441597242;1487726306;46129064;762.716.005.291.005
jbardera/RoamingInfo;com.brapeba.roaminginfo;G;40;1394316943;1444327639;50010696;826.896.428.571.429
talobin/cardentry;com.sincerely.android.postagram;G;40;1435126295;1485760766;50634471;837.210.168.650.794
marcusschiesser/gallerista;de.marcusschiesser.wallpapers;G;40;1360938030;1419599104;58661074;969.925.165.343.915
succlz123/S1-Go;org.succlz123.s1go.app;G;40;1429615336;1493116308;63500972;104.994.993.386.243
fernandomantoan/ramais-pti-android;com.fernandomantoan.ramaispti.android;G;40;1371936200;1444136788;72200588;119.379.279.100.529
richev/PlanningPokerPlusPlus;com.richev.planningpokerplusplus;G;40;1315041788;1402411321;87369533;144.460.206.679.894
rvdevelopment123/https-github.com-nadam-nfc-reader;se.anyro.nfc_reader;G;40;1321301832;1488193620;166891788;275.945.416.666.667
Grarak/KernelManager;com.grarak.kernel.manager;G;41;1413627696;1419262213;5634517;931.633.101.851.852
MikiLoz92/FancyAdapters;com.mobymagic.musicplayer;G;41;1471346759;1480266679;8919920;14.748.544.973.545
ak1801/MilkDiary;manaksh.com.milkdiary;G;41;1449506414;1458716712;9210298;152.286.673.280.423
ravendyg/gortrans-android;info.nskgortrans.maps;G;41;1477823527;1489299232;11475705;189.743.799.603.175
tomasdr1/BigFile;com.benjinator.bigfile;G;41;1457856613;1474792380;16935767;280.022.602.513.228
daneshzaki/nadget;in.pleb.nadget;G;41;1457806949;1493562938;35755989;591.203.521.825.397
Pavel87/DeviceDiag;com.pacmac.devicediag.free;G;41;1443899605;1488010229;44110624;729.342.328.042.328
eskerda/citybikes;net.homelinux.penecoptero.android.citybikes.app;F;41;1278747602;1326474626;47727024;789.137.301.587.302
jselbie/wrekonline;com.selbie.wrek;G;41;1398062818;1459227979;61165161;10.113.287.202.381
tomjaspers/vubresto-android;be.tjs.vubrestaurant;G;41;1411667334;1476527122;64859788;107.241.712.962.963
renlijie/TripTrack;com.triptrack;G;41;1337195753;1417252902;80057149;132.369.624.669.312
sathishmscict/Android-ParallaxHeaderViewPager;com.kmshack.newsstand;G;41;1399745985;1488864543;89118558;147.352.113.095.238
xgouchet/Ted;fr.xgouchet.texteditor;F;41;1330422983;1444727495;114304512;188.995.555.555.556
WesBunton/MyCertificates;com.wesbunton.projects.mycertificates;G;42;1481991360;1488419139;6427779;10.627.941.468.254
deeps2/Delhi06;com.shikhardeep.android.delhi06;G;42;1476630485;1487308207;10677722;176.549.636.243.386
Etsuni/YANA;fr.nover.yana&amp;G;42;1371806505;1382567688;10761183;177.929.613.095.238
thedumbestapps/gairoutes;com.tda.gairoutes;G;42;1441557326;1452801955;11244629;185.923.098.544.974
arundil/OCR7Segments;org.ocr.sevensegments.mainActivity;G;42;1473936468;1489514615;15578147;257.575.181.878.307
nervousnet-virtual-sensors/NervousnetCompetitionGame;ch.ethz.coss.nervous.competition;G;42;1432771892;1449063644;16291752;269.374.206.349.206
rustamgaifullin/iReminders;org.dmfs.caldav.lib;G;42;1430642303;1449958027;19315724;319.373.743.386.243
sanggonlee/FoodNote;sanggon.foodnote;G;42;1440560960;1461279122;20718162;342.562.202.380.952
rviannaoliveira/VMap;com.rviannaoliveira.jachegou;G;42;1470002037;1491265152;21263115;351.572.668.650.794
andresort28/braillapp-android;com.project.rubikon.braillapp&amp;G;42;1445563148;1474928018;29364870;485.530.257.936.508
zyou1986/cpu;org.anothermonitor;G;42;1427414349;1464090196;36675847;606.412.814.153.439
jimzhaozhengwang/DOTA-2-Timer-Reminder;ucalled911.DOTA2TimerAndReminder;G;42;1453244173;1493774790;40530617;670.149.090.608.466
vat78/FengOffice_TimeTracker;ru.vat78.fotimetracker;G;42;1448346500;1492602665;44256165;731.748.759.920.635
Pozzoooo/WakeOnLan;com.pozzo.wakeonlan;G;42;1399936912;1457007369;57070457;943.625.281.084.656
ohmage/android-stream-lib;org.ohmage.mobility;G;42;1341962723;1401825841;59863118;989.800.231.481.481
0xnm/BTC-e-client-for-Android;com.QuarkLabs.BTCeClient;G;42;1401914705;1478026206;76111501;125.845.735.780.423
iutinvg/buxoff;com.sevencrayons.buxoff;G;42;1344566543;1431317858;86751315;143.438.020.833.333
ZorgeR/BTC-e.com-monitor;com.zlab.btcmonitor;F;42;1386622849;1480890255;94267406;155.865.419.973.545
glasgowneuro/AttysECG;tech.glasgowneuro.attysecg;G;43;1484649460;1490221875;5572415;921.364.914.021.164
iamironrabbit/monlam-dictionary;org.lobsangmonlam.dictionary&amp;G;43;1466397992;1472653667;6255675;103.433.779.761.905
Konstie/GeekNotes-v0.2;com.gnotes.app;G;43;1436018323;1442413273;6394950;105.736.607.142.857
olgamiller/SSTVEncoder2;xdsopl.robot36;G;43;1483464765;1490216724;6751959;111.639.533.730.159
antionio/Dodge-The-Cars;com.sturdyhelmetgames.dodgethecars;G;43;1341086003;1354755346;13669343;226.014.269.179.894
laramartin/android_video_game_random_quote;eu.laramartin.videogamequotes;G;43;1461681924;1475524829;13842905;228.884.011.243.386
SJSU272Lab/Consumit;prachihada.eatfoodv2&amp;G;43;1474565192;1490389279;15824087;261.641.650.132.275
tanallnight/Blip;com.tanmay.blip;F;43;1436798922;1458871214;22072292;364.951.917.989.418
budowski/budoist;budo.budoist;F;43;1330640211;1353765280;23125069;38.235.894.510.582
Kestutis-Z/UK-Weather-repo;com.haringeymobile.ukweather;G;43;1395364880;1420761985;25397105;419.925.677.910.053
lukaspili/Reactive-Billing;com.github.lukaspili.reactivebilling.sample;G;43;1462573682;1490020430;27446748;453.815.277.777.778
kchen52/2na;com.kchen52.twona;G;43;1461628291;1489978480;28350189;468.753.125
piyushg91/HiitTimer;gupta.piyush.hiittimer&amp;G;43;1376759522;1406608638;29849116;493.536.970.899.471
agarwalamit662/MusicIndia;com.support.android.tinyplayer;G;43;1454656236;1487405427;32749191;541.487.946.428.571
johnnycardy/harmonica-key-finder;com.johnnycardy.keyfinder;G;43;1334511179;1372456846;37945667;62.740.851.521.164
xjcook/TextConverter;com.androidsmash.apps.changeencoding;G;43;1442523129;1481709285;39186156;647.919.246.031.746
Fibonacci-/Helpdesk-Solarwinds;com.helwigdev.helpdesk;G;43;1445009886;1489848069;44838183;741.372.073.412.698
ajavamind/Processing-Cardboard;com.modla.andy.swarm3dfree;G;43;1437079036;1484586401;47507365;785.505.373.677.249
graetzer/android-MensaPlanner;de.rwth_aachen.comsys.assignment2;G;43;1429745794;1485515246;55769452;922.113.955.026.455
takke/cpustats;jp.takke.cpustats;G;43;1390575669;1447076899;56501230;934.213.458.994.709
SonarQubeCommunity/sonar-android-application;hu.balazsbakai.sq&amp;G;43;1383662625;1444914765;61252140;101.276.686.507.937
MFlisar/MessageBar;com.michaelflisar.messagebartest;G;43;1374612423;1445434471;70822048;117.099.947.089.947
alistairdickie/BlueFlyVario_Android;com.bfv;F;43;1348831794;1451815836;102984042;170.277.847.222.222
xtuaok/android_share_gyazo;xtuaok.sharegyazo;G;43;1352879275;1470023410;117144135;193.690.699.404.762
Haffinsky/BudgetGamer;haffa.budgetgamer;G;44;1480028808;1492109238;12080430;19.974.255.952.381
tonyshkurenko/MobileChallenge_game;com.mobilechallenge.game;G;44;1445156841;1463088743;17931902;296.493.088.624.339
raj-subhankar/DownInsta;com.yellowsoft.subhankar.downinsta;G;44;1462867331;1481779064;18911733;312.693.998.015.873
flaviojmendes/hefesto;com.fjmob.ponto;G;44;1442263404;1468321214;26057810;430.850.033.068.783
Pavel87/TrackR;com.pacmac.trackr;G;44;1461735290;1488750413;27015123;446.678.621.031.746
alt236/Android-Drawables---Android;aws.apps.androidDrawables;F;44;1328571260;1363484660;34913400;577.271.825.396.825
pengrad/raspkursk;com.pengrad.raspkursk;G;44;1437086385;1474635037;37548652;620.844.113.756.614
boxhead201/MorseClock;com.boxhead.android.morseclock;G;44;1441598445;1487752919;46154474;763.136.144.179.894
noboru-i/ReadItNow;hm.orz.chaos114.android.readitnow;G;44;1353844344;1406261283;52416939;866.682.192.460.317
davidvavra/GPS-Averaging;org.destil.gpsaveraging;G;44;1344435363;1443304360;98868997;163.473.870.701.058
dozingcat/AsciiCam;com.dozingcatsoftware.asciicam;F;44;1321201416;1485713439;164512023;272.010.620.039.683
vinzdez/ColorMemory;colormemory.vicente.com.colormemory;G;45;1461422376;1466657324;5234948;865.566.798.941.799
rootkit007/cobra-iradar-notifier;com.greatnowhere.radar;G;45;1399058973;1404758139;5699166;942.322.420.634.921
kollerlukas/TODOList-Android-App;us.koller.todolist;G;45;1473224127;1482211071;8986944;148.593.650.793.651
MuShare/Rate-Android;org.mushare.rate;G;45;1481895849;1491752148;9856299;162.967.906.746.032
dhruv2601/News-Ton;dhruv.newsfeed;G;45;1471031514;1485695618;14664104;242.462.037.037.037
gektor650/checkersCorners;net.mydebug.corners;G;45;1365704588;1381946131;16241543;268.544.031.084.656
progcode/TNW.Mobile;io.wpositive.tnwmobileionic;G;45;1465998190;1490386021;24387831;403.237.946.428.571
roelb/Simple-C25K;nl.ttys0.simplec25k;F;45;1332154715;1371586503;39431788;651.980.621.693.122
project-voodoo/screen-test-patterns-app;org.projectvoodoo.screentestpatterns;F;45;1311287843;1374631076;63343233;104.734.181.547.619
vsamov/blog-reader;com.valerysamovich.app;G;45;1400559224;1466826476;66267252;109.568.869.047.619
sanskrit-coders/stardict-dictionary-updater;sanskritcode.sanskritdictionaryupdater;G;45;1421595511;1493157072;71561561;118.322.686.838.624
PDDStudio/earthview-android;com.pddstudio.earthviewer;F;46;1449770984;1455115742;5344758;883.723.214.285.714
iskandarshabaev/weather;com.ishabaev.weather;G;46;1466109144;1476396722;10287578;170.098.842.592.593
dbooga/MonsterHunter3UDatabase;com.daviancorp.android.mh3udatabase&amp;G;46;1411889072;1422486290;10597218;175.218.551.587.302
pattonj/BereaConvo;com.jacob.patton.bereaconvo;G;46;1362511596;1376401589;13889993;229.662.582.671.958
numixproject/org.numixproject.torch;org.numixproject.torch;G;46;1417809068;1432758517;14949449;247.180.042.989.418
prabashbala/ServiceOnt;uk.co.balasuriya.serviceont;G;46;1412195353;1430840964;18645611;308.293.832.671.958
leesunghyun/wordbook;com.wordbook.smartword;G;46;1453017149;1474261067;21243918;351.255.257.936.508
nomad5modules/CircularProgressView;com.nomad5.circularprogress;G;46;1431262745;1460636547;29373802;485.677.943.121.693
powerje/NyanDroid;com.powerje.nyan;F;46;1315363679;1383449067;68085388;112.575.046.296.296
d355/sms-trial;dtd.phs.sil;G;46;1313717876;1441734233;128016357;211.667.256.944.444
hsaito/hstempo_android;hsware.HSTempo;F;46;1234094711;1457061994;222967283;368.662.835.648.148
davidru85/CarLocator;com.davidru85.carlocator;G;47;1388263794;1394125625;5861831;969.218.088.624.339
whiteSkar/Blackjack_VR;com.DoomChitGames.BlackjackVR;G;47;1450141575;1457212437;7070862;116.912.400.793.651
montecode/fox-run;me.montecode.games.runningmonster.android;G;47;1413629078;1421666398;8037320;132.892.195.767.196
aaronistheman/Android-State-Capitals-App;com.aaronistheman.statecapitals&amp;G;47;1442550026;1451978881;9428855;155.900.380.291.005
Gr33nLight/Azur;musicstream.gr33napps.com.musicstream;G;47;1450826542;1467550615;16724073;276.522.371.031.746
Lutka/NationalAnthems;com.lutka.nationalanthems;G;47;1418417235;1435762973;17345738;286.801.223.544.974
cpslab/CityWalkersMeter;jp.ac.dendai.im.cps.citywalkersmeterkai;G;47;1440437801;1462695166;22257365;368.011.987.433.862
qwert2603/VK-Message-Stat;com.qwert2603.vkmessagestat;G;47;1466684738;1489755290;23070552;38.145.753.968.254
thomasfischersm/LSystemAndroid;com.playposse.thomas.lindenmayer;G;47;1463771472;1487889416;24117944;398.775.529.100.529
lociii/TrackMap;de.jensnistler.trackmap;G;47;1335893506;1361016250;25122744;415.389.285.714.286
jimandreas/OpenGLES-sandbox;com.learnopengles.sandbox&amp;G;47;1454615868;1480265685;25649817;424.104.117.063.492
tananaev/passport-reader;com.tananaev.passportreader;F;47;1460024775;1490782521;30757746;508.560.615.079.365
ashdavies/data-binding;com.chaos.databinding;G;47;1433191993;1464943374;31751381;52.498.976.521.164
whiteSkar/LittleSnake;com.DoomChitGames.LittleSnake;G;47;1416719367;1456891904;40172537;664.228.455.687.831
twho/Intelligent-Power-Saving-Android;com.tsungweiho.intelligentpowersaving;G;47;1440323125;1489215211;48892086;808.400.892.857.143
SamKnows/skandroid-fcc;com.samknows.fcc;G;47;1401175277;1460015021;58839744;972.879.365.079.365
romelusw/os_project;com.romelus_tran.cottoncandymonitor&amp;G;47;1383509247;1444365437;60856190;100.622.007.275.132
Narfss/ParallaxEverywhere;com.fmsirvent.ParallaxEverywhereSample;G;47;1415008149;1479831023;64822874;107.180.677.910.053
harri35/res-check;com.harrikirik.rescheck;G;47;1377793705;1453909375;76115670;125.852.628.968.254
midhunhk/random-contact;com.ae.apps.randomcontact;G;47;1384077243;1474464897;90387654;149.450.486.111.111
olivaceously/treble-app;com.treble.www.full;G;48;1475194573;1481908362;6713789;111.008.416.005.291
daniellu789/TripCard;com.levart.TripCard&amp;G;48;1430778916;1441230180;10451264;172.805.291.005.291
aggarwalankush/Interview2go;com.aggarwalankush.interview2go;G;48;1448508703;1459641000;11132297;184.065.757.275.132
adiviness/DrunkFriend;com.austindiviness.drunkfriend;G;48;1359930931;1376971118;17040187;281.749.123.677.249
felixb/portal-timer;de.ub0r.android.portaltimer;F;48;1359215412;1383534282;24318870;402.097.718.253.968
JohnnyJem/ImgurWorkout;com.johnnymolina.imgurworkout;G;48;1430960458;1456972078;26011620;43.008.630.952.381
ledongthuc/worldcup-results;vn.com.thuc.worldcupresults2;G;48;1401299200;1428666464;27367264;452.501.058.201.058
superjeffreyc/Linear-Algebra-Helper;com.jeffreychan.enterthematrix;G;48;1445216355;1492897405;47681050;788.377.149.470.899
wiiaam/srht-android;io.github.wiiam.srhtandroid;G;48;1436429403;1484729199;48299796;798.607.738.095.238
sentinelweb/vectoroid;co.uk.sentinelweb.vectoroid.example.basic;G;48;1334760084;1455735261;120975177;200.025.094.246.032
hdantas/touch-draw;net.henriquedantas.android.touchanddraw;G;49;1414497169;1421198425;6701256;11.080.119.047.619
dobots/Dodedodo_Android;org.dobots.mymodule;G;49;1378130826;1392394670;14263844;235.843.981.481.481
metem/SimpleChecklist;com.simple_checklist;G;49;1466704932;1483714591;17009659;281.244.361.772.487
andli/NRClicker;net.pooksoft.nrclicker;G;49;1415751736;1433863419;18111683;299.465.658.068.783
sakebook/CustomTabsSample;com.sakebook.android.sample.customtabssample;G;49;1469546700;1489322253;19775553;326.976.736.111.111
AlexanderShtanko/firebase-psychotests-android;com.alexandershtanko.psychotests;G;49;1465848323;1491556457;25708134;425.068.353.174.603
kwhite17/Nudge;com.ksp.nudge;G;49;1411924084;1442790623;30866539;510.359.441.137.566
sasuomi/risteilyohjelma14;org.jouluristeily.risteilyohjelma14;G;49;1408294610;1439362312;31067702;513.685.548.941.799
chrsep/Portal;com.directdev.portal;G;49;1442934120;1474968868;32034748;529.675.066.137.566
TapTrack/TappyBLE;com.taptrack.bletappyexample;G;49;1456782536;1491256941;34474405;570.013.310.185.185
swu06/lookingbusy;com.lookingdynamic.lookingbusy;G;49;1441504257;1484844352;43340095;716.602.099.867.725
TheLester/mytaskmanager;com.dogar.mytaskmanager;F;49;1402260561;1447097149;44836588;741.345.701.058.201
m039/instant-sms-ussd;com.m039.mqst;F;49;1314632502;1387672460;73039958;120.767.126.322.751
GrahamBlanshard/WiseRadar;wiseguys.radar;G;49;1358823968;1447762254;88938286;147.054.044.312.169
dkovalkov/Sketcher-Tab;org.sketchertab;G;49;1316023480;1420484495;104461015;172.719.932.208.995
geometer/FBReaderJ-plugin-tts;org.geometerplus.fbreader.plugin.tts;F;49;1308410415;1433821179;125410764;207.359.067.460.317
deeps96/SensorMax;com.deeps.sensormax;G;50;1420825394;1427730159;6904765;114.166.087.962.963
savepopulation/wikilight;com.raqun.wiki;G;50;1471197239;1492110820;20913581;345.793.336.640.212
JeremyWeed/SpaceGame;com.spacegdx.game.android;G;50;1430275226;1453336910;23061684;381.310.912.698.413
otsenreDC/weathercok;io.bananalabs.weathercok;G;50;1422401682;1452451818;30050136;496.860.714.285.714
TobbenTM/HiG-TimeEdit-Reader;com.tobbentm.higreader;G;50;1378202237;1428397295;50195058;829.944.742.063.492
stevewest/VO-Miner;com.uruwolf.vominer;G;50;1336212745;1387065656;50852911;840.821.941.137.566
CODA-Masters/Pong-Tutorial;com.codamasters.pong;G;50;1430491673;1492184219;61692546;102.004.871.031.746
jp9/DonotDisturb;com.colossaldb.dnd;G;50;1386748931;1488744777;101995846;16.864.392.526.455
kl/ANTLightController;com.dsi.ant.usbservice;G;51;1375095344;1380370896;5275552;872.280.423.280.423
busylee999/issue-handler;com.busylee.issuebot;G;51;1421486124;1429446237;7960113;131.615.625
ftlno/abakaffe-android;no.ftl.abakaffe;G;51;1385731421;1394546851;8815430;145.757.771.164.021
BeppiMenozzi/TriStateToggleButton;it.beppi.bootwithlogo;G;51;1479688554;1488555402;8866848;146.607.936.507.937
bacampbell/Compass;com.bcampbelldev.compassapp;G;51;1478036455;1487192491;9156036;151.389.484.126.984
pramodmg/Clime-TheWeatherApplication;com.app.weather&amp;G;51;1402921517;1421992373;19070856;315.325
pannous/Voice2Web;com.pannous.voice.actions.free;G;51;1318617576;1340232248;21614672;35.738.544.973.545
azki/smishing;org.azki.smishing;G;51;1378886803;1404217883;25331080;418.833.994.708.995
abhishekarora185/Swipeball;com.SurrealInc.Swipeball;G;51;1446458634;1472320980;25862346;427.618.154.761.905
mslhii/CPUInfo;com.kritikalerror.cpuinfo;G;51;1420279041;1453710987;33431946;552.776.884.920.635
AlexisDeschamps/tournament-architect;com.gmail.descalexis.tournamentarchitect;G;51;1449155793;1490115010;40959217;677.235.730.820.106
codeTom/glstn;sk.ayazi.glstnzastupovanie;G;51;1380137277;1421790733;41653456;68.871.455.026.455
Earthblood/Toe;com.earthblood.tictactoe;G;51;1396065050;1441768978;45703928;75.568.664.021.164
wlky/AnkiDroid-Wear;com.ichi2.anki;G;51;1429609714;1477434487;47824773;790.753.521.825.397
kconger/org.thecongers.mtpms;org.thecongers.mtpms;G;51;1401484724;1477064849;75580125;124.967.137.896.825
gjtorikian/Shelves;com.miadzin.shelves;F;51;1356991925;1478074379;121082454;200.202.470.238.095
canapio/HangeulClock-Android;com.hangulclock.hansi;G;52;1444364934;1449459399;5094465;84.233.878.968.254
iSkill-Hackathon/SuperMe;ie.mylifesolutions.superme&amp;G;52;1459763847;1474116602;14352755;237.314.070.767.196
Efesto/red-vs-green;efestoarts.wearfaces;G;52;1430910529;1447601022;16690493;275.967.146.164.021
dingdingyr/ImmortalPlayer-;com.immortalplayer;G;52;1412018742;1442489197;30470455;503.810.433.201.058
NahroTo/Teleport-Ball;com.nahroto.teleportball.android;G;52;1440948917;1476700115;35751198;591.124.305.555.556
stevyhacker/guessthecity-app;me.montecode.simplequizapp.gradovi;G;52;1415747335;1452036410;36289075;600.017.774.470.899
kevinzavier/Saylii-Travels;com.release.kevinzavier.sayliitravels;G;52;1442955821;1481751352;38795531;641.460.499.338.624
BlochsTech/BitcoinCardTerminal;com.blochstech.bitcoincardterminal;G;52;1430228896;1469667722;39438826;652.096.990.740.741
pgrim/pixeldungeonq;com.watabou.cpixeldungeon;G;52;1406396072;1476318871;69922799;115.613.093.584.656
nischalshrestha/standUp;com.bitsorific.standup;G;53;1454990024;1466373219;11383195;188.214.203.042.328
apkola/muzei-lastfm;com.apkola.muzei.lastfm;G;53;1406580080;1418474936;11894856;196.674.206.349.206
gpetuhov/Yellowstone;com.gpetuhov.android.yellowstone;G;53;1473341673;1485440268;12098595;200.042.906.746.032
tripleducke/Capstone-Project;com.robsterthelobster.ucibustracker&amp;G;53;1466393071;1479414622;13021551;215.303.422.619.048
tlewiscpp/QMineSweeper;com.pinguinsan.qminesweeeper;G;53;1476447508;1491514140;15066632;249.117.592.592.593
sweetiepiggy/Every-Locale;com.sweetiepiggy.everylocale;G;53;1328976062;1373124165;44148103;729.962.020.502.646
SimonSchubert/LinuxCommandBibliotheca;com.inspiredandroid.linuxcommandbibliotheca;G;53;1403136837;1488791217;85654380;141.624.305.555.556
pelletized/JWSongs;com.pelletized.jwsongs&amp;G;53;1377905732;1475539691;97633959;161.431.810.515.873
bluesky139/LTweaks;li.lingfeng.ltweaks;G;54;1484306319;1490798956;6492637;107.351.802.248.677
LipeDuoli/PriceCompare;br.com.duoli.pricecompare;G;54;1482609187;1491870268;9261081;153.126.339.285.714
alexeyosminin/sensor_puck_demo;com.osminin.sensorpuckdemo;G;54;1478617404;1489602002;10984598;181.623.644.179.894
tonyjs/Hashtagram;com.orcpark.hashtagram;G;54;1415867052;1435890062;20023010;331.068.287.037.037
JMS-1/BitMe;net.psimarron.bitme;G;54;1425401414;1450029749;24628335;407.214.533.730.159
scottmangiapane/quackcryption;co.twoduck.quackcryption;G;54;1456552454;1481402334;24849880;410.877.645.502.646
meirtz4/Randwik;com.randwik_pack;G;54;1372171385;1400919149;28747764;475.326.785.714.286
gsi-upm/ewe-tasker-android;es.dit.gsi.rulesframework;G;54;1445879185;1485262042;39382857;651.171.577.380.952
GoneUp/Htwg_LsfPlan;com.hstrobel.lsfplan;G;54;1447109876;1490632374;43522498;719.618.022.486.772
wburhan2/TodayInTech;com.wilsonburhan.todayintech;G;54;1411010556;1461272195;50261639;831.045.618.386.243
Ashkan-Sarlak/YWeatherGetter4a-edited;zh.wang.android.yweathergetter;G;54;1347602969;1404623230;57020261;942.795.320.767.196
CitySDK/CitySDK-Android;com.citysdk.demo;G;54;1395058091;1454327838;59269747;979.989.203.042.328
gregfmartin/theshopper-old;com.quorraapps.theshopper;G;54;1335028125;1401494083;66465958;109.897.417.328.042
nibuen/SpaceAlertMissionGenerator;com.boarbeard&amp;G;54;1402084287;1472245174;70160887;11.600.675.760.582
ari633/TwitClient;com.tugasakhir.twitclient;G;54;1352486286;1468234918;115748632;19.138.332.010.582
mportuesisf/ScreenInfo;com.jotabout.screeninfo;F;54;1294534449;1430619511;136085062;225.008.369.708.995
Kaljurand/Diktofon;kaljurand_at_gmail_dot_com.diktofon;G;54;1336836275;1485730042;148893767;246.186.784.060.847
epoiate/Card-Game-LP-Calculator;com.poiate.yugiohLPC;G;55;1393426904;1398686488;5259584;869.640.211.640.212
marono/Xsseract;ro.onos.xsseract;G;55;1431956659;1437473022;5516363;912.097.056.878.307
takuan-oishii/PixelSoldiers;com.studio2.pixelsoldiers&amp;G;55;1376369701;1383354652;6984951;11.549.191.468.254
Gperez88/MovieReleases;com.gperez88.moviereleases;G;55;1425915135;1435435622;9520487;157.415.459.656.085
cpinan/CapstoneProject;com.carlospinan.champions;G;55;1454426176;1464402695;9976519;164.955.671.296.296
benhenn/Lets-Pic-app;com.pragmaticcoder;G;55;1395708552;1428923723;33215171;549.192.642.195.767
pavlospt/CircleView;com.hungry;G;55;1405856589;1472723233;66866644;110.559.927.248.677
SethuVignesh/2048-SuperStarVersion;com.uberspot.a2048;G;55;1394804721;1473541190;78736469;130.185.960.648.148
HanleyTang/iforward;cn.xm.hanley.iforward.activity&amp;G;55;1345023353;1433919434;88896081;146.984.260.912.698
nilsm/typeandspeak;com.googamaphone.typeandspeak&amp;G;55;1313568342;1452005281;138436939;228.897.055.224.868
IvanVolosyuk/wifikeyboard;com.volosyukivan;G;55;1274448628;1446868261;172419633;285.085.372.023.809
lenamuit/FPhotos;com.namlh.fphotos;G;56;1407259421;1412232579;4973158;822.281.415.343.915
applico/LPreviewGoogleZeitgeist;com.google.android.apps.zeitgeist&amp;G;56;1410557597;1418149910;7592313;125.534.275.793.651
ClarkAWilson/QuarkPosts;com.clarkawilson.quarkposts;G;56;1439065173;1453344029;14278856;236.092.195.767.196
grantland/dashclock-battery-localization;me.grantland.dashclock_battery;G;56;1389432101;1405563729;16131628;266.726.653.439.153
TatsuoWatanabe/FunUkuleleQuiz;com.tatsuowatanabe.funukulelequiz;G;56;1446808567;1464572763;17764196;293.720.171.957.672
PeterChu2/Identi-Color;com.forCHUApps.identi_Color&amp;G;56;1400522094;1423966435;23444341;387.637.913.359.788
nbehary/Retribution;com.nbehary.retribution;G;56;1430166272;1458158164;27991892;462.828.902.116.402
justquizz/JustQuizzAndroid;ru.lightapp.justquizz;G;56;1440960340;1469501403;28541063;471.909.110.449.735
javiersantos/Moticons;com.javiersantos.moticons;F;56;1437903510;1468058692;30155182;498.597.585.978.836
SwapnilShahGit/GTAFoody;com.Oguzhan.Swapnil.GTAFoody&amp;G;56;1432219171;1465394197;33175026;548.528.869.047.619
MathiasSeguy-Android2EE/ForecastYahooRest;com.android2ee.formation.restservice.sax.forecastyahoo;G;56;1402924847;1476103597;73178750;120.996.610.449.735
j4velin/SystemAppMover;de.j4velin.systemappmover;F;56;1384966795;1477124964;92158169;152.377.924.933.862
martinmarinov/rtl_tcp_andro-;marto.rtl_tcp_andro;G;56;1357767700;1491127879;133360179;220.502.941.468.254
Riamu/pinch;com.liamhartery.pinch;G;57;1470590210;1478190927;7600717;125.673.230.820.106
rgoodie/TerpTools2;rg.TerpTools;G;57;1387742815;1396015985;8273170;136.791.832.010.582
hecosire/hecosire-androidapp;hecosire.com.hecosireapp;G;57;1420203955;1429520323;9316368;154.040.476.190.476
mhidaka/EventApp;org.techbooster.app.abc2013autumn;G;57;1382406320;1395336620;12930300;213.794.642.857.143
JoshuaChing/4Squares;com.jchingdev.squares;G;57;1419146515;1433133205;13986690;231.261.408.730.159
Jude95/KeyChain;com.jude.keychain;G;57;1446536574;1464331382;17794808;294.226.322.751.323
ngageoint/anti-piracy-android-app;mil.nga.giat.asam;G;57;1402846630;1423505164;20658534;34.157.628.968.254
Sandmole/Elo-Rating-Formula;com.Centaurii.app.RatingCalculator;G;57;1368945965;1400187753;31241788;516.563.955.026.455
dagar/LunchRanker;ca.dagar.lunchranker;G;57;1402682424;1434297250;31614826;522.731.911.375.661
telpirion/ClassicsReader;com.ericmschmidt.latinreader;G;57;1453496142;1489891075;36394933;601.768.072.089.947
JCERTIFLab/jcertif-android-2012;com.jcertif.android&amp;G;57;1308123028;1353114249;44991221;743.902.463.624.339
project-voodoo/ota-rootkeeper-app;org.projectvoodoo.otarootkeeper;F;57;1314316365;1365969094;51652729;85.404.644.510.582
boxhead201/BoxRSS;com.boxhead.android.rss;G;57;1441595239;1493545095;51949856;858.959.259.259.259
andrewcmyers/multilist;edu.cornell.cs.multilist;G;57;1437208234;1491156037;53947803;891.994.097.222.222
tivtag/twowaybox;com.federrot.twowaybox;G;57;1375634855;1453837102;78202247;12.930.265.707.672
cameronkeif/RussianWordOfTheDay;edu.msu.keifcame.russianwordoftheday&amp;G;57;1373680514;1487969474;114288960;188.969.841.269.841
google/ringdroid;com.ringdroid;F;57;1224271038;1480745615;256474577;424.065.107.473.545
georgelam-uwaterloo/GoodHikes;ca.uwaterloo.magic.goodhikes;G;58;1455038497;1459977257;4938760;816.593.915.343.915
andreybl/GuitarTrainer;org.cohortor.gstrings&amp;G;58;1353692344;1361139768;7447424;123.138.624.338.624
DanyEle/appiedipertrento;com.appiedi.appiedipertrento;G;58;1388860813;1400863395;12002582;19.845.539.021.164
ranveeraggarwal/LeaveTracker;com.ranveeraggarwal.letrack;G;58;1476102252;1492415529;16313277;269.730.109.126.984
NyamEnkhbat/AndroidAccelerate;eu.isawsm.accelerate;G;58;1422457143;1443042408;20585265;340.364.831.349.206
andrkhar/TheFreeBird;work.hungrygnu.thefreebird;G;58;1455218318;1476169344;20951026;346.412.466.931.217
cmykola/Lexin;com.mykola.lexinproject;G;58;1346534137;1370642360;24108223;398.614.798.280.423
sekmenhuseyin/AndroidNamazVaktim;net.sekmetech.namazvaktim;G;58;1454949465;1482059517;27110052;448.248.214.285.714
jamesmorgan/WhosMakingTheBrew;com.morgan.design;G;58;1382274779;1448793508;66518729;109.984.670.965.608
yupog2003/TripDiary;com.yupog2003.tripdiary;G;58;1420551018;1493910337;73359319;121.295.170.304.233
kt3k/com.kt3k.app.hw;com.kt3k.app.hw;G;58;1350823560;1484709041;133885481;221.371.496.362.434
useyourname/ImgurCam;com.hulq.ImgurCam&amp;G;59;1384489215;1390442029;5952814;984.261.574.074.074
DWoodhouse22/StreetCrimes;com.dwoodhouse.streetcrimes;G;59;1404753563;1411926780;7173217;118.604.778.439.153
blablanumerodeux/Youtube-Subscriptions-TV;tv.subscriptions.subscriptionstv;G;59;1477675018;1485273919;7598901;125.643.204.365.079
bkgummadi/Billy;com.vibin.billy;G;59;1401637376;1414868408;13231032;218.767.063.492.063
uriio/beacons-android;com.uriio;G;59;1462571555;1491224321;28652766;473.756.051.587.302
romanbb/AOKP_Backup;com.aokp.backup;F;59;1337008839;1369764195;32755356;541.589.880.952.381
kromonos/Mustard-Mod;org.mumod.android;F;59;1352575759;1385415984;32840225;542.993.138.227.513
KushKD/HPSRDH;in.gov.hp.aadhaar.hpsrdh;G;59;1433399409;1474015763;40616354;67.156.669.973.545
Pozzoooo/travelWeather;pozzo.apps.travelweather;G;59;1444006133;1493763891;49757758;822.714.252.645.503
joeybronner/freehandtwitter;fr.joeybronner.freehandtwitter;G;59;1421439552;1475661625;54222073;89.652.898.478.836
hwki/SimpleBitcoinWidget;com.brentpanther.bitcoinwidget;F;59;1364159880;1493089073;128929193;213.176.575.727.513
CyanogenMod/android_packages_inputmethods_PinyinIME;com.google.android.inputmethod.pinyin;F;59;1238054926;1374709518;136654592;225.950.052.910.053
efarraro/deckerino;com.slothwerks.hearthstone.compendiumforhearthstone;G;60;1410311522;1417997705;7686183;127.086.359.126.984
nejoyer/NotYet;com.outlook.notyetapp;G;60;1479315214;1493388814;14073600;232.698.412.698.413
egorpushkin/iremote;com.scientificsoft.iremote.android.iremote;G;60;1382642315;1398547800;15905485;262.987.516.534.392
adamkdot/my_ip_address_info;com.adamkruger.myipaddressinfo;F;60;1410920997;1429829659;18908662;312.643.220.899.471
Inlife/circle;inlife.circle&amp;G;60;1448886800;1471128629;22241829;367.755.109.126.984
leotianlizhan/Overwatch;something.overwatch;G;60;1465665353;1493790517;28125164;465.032.473.544.974
Alexxz/Hawkingquotes;com.alexxz.hawkingquotes;G;60;1388003835;1436540451;48536616;802.523.412.698.413
mwong56/e46diy;com.mwong56.e46.maintenance&amp;G;60;1359364052;1419737730;60373678;99.824.203.042.328
PPilmeyer/drawchemy;draw.chemy;G;60;1402710244;1468137934;65427690;108.180.704.365.079
mhyhre/Zone-1024;com.mhyhre.zone_1024;G;60;1394618084;1474910473;80292389;132.758.579.695.767
arpankundu007/Lab-Assistant;com.labmate.warmach.labmate;G;61;1468863672;1474696316;5832644;964.392.195.767.196
soduor/WorldCountriesPuzzle;com.omondi.stepen.worldcountriespuzzle;G;61;1487305403;1493832418;6527015;107.920.221.560.847
TatsuoWatanabe/Fukuchan15Puzzle;com.tatsuowatanabe.fukuchan15puzzle;G;61;1403027332;1413408040;10380708;17.163.869.047.619
activems/clipcaster;com.actisec.clipcaster;F;61;1414440106;1426808402;12368296;204.502.248.677.249
jbatonnet/goontap;net.thedju.GoOnTap;G;61;1474654628;1489014574;14359946;23.743.296.957.672
zaki50/MemoPad;org.zakky.memopad;F;61;1305678407;1328630449;22952042;379.498.048.941.799
ricburton/Tug;com.kite.tug;G;61;1331025230;1371775901;40750671;673.787.549.603.175
jblouie/BirdWalk;com.jle.josh.birdwalk;G;61;1448181479;1489947953;41766474;690.583.234.126.984
ferustigris/digger;ferus.tigris.digger;G;61;1364110249;1407655164;43544915;719.988.673.941.799
jfilowk/TeamFacto;com.jfilowk.teamfactory;G;61;1411054634;1461012802;49958168;82.602.791.005.291
techlung/GlowAndroid;com.techlung.android.glow;G;61;1435145419;1485595494;50450075;834.161.292.989.418
carles-ruis/android-jogging;com.carles.jogging;G;61;1398025708;1470231310;72205602;119.387.569.444.444
qpython-android/qpython;org.qpython.qpy;G;61;1397214351;1493881238;96666887;159.832.815.806.878
uberspot/2048-android;truong.offline2048;F;61;1394804721;1491918340;97113619;160.571.459.986.772
andresoviedo/android-3D-model-viewer;org.andresoviedo.dddmodel2;G;61;1382393373;1492980470;110587097;182.849.036.044.974
gvellut/Android_OSM_offlinemap;com.vellut.offlinemap.tokyo;G;62;1389201514;1394957404;5755890;951.701.388.888.889
fodpeter/MathClock;peter.mathclock;G;62;1471072668;1478333942;7261274;120.060.747.354.497
jereksel/RomManager;com.koushikdutta.rommanager&amp;G;62;1398385200;1409228531;10843331;179.287.880.291.005
PileOnDevs/pile-on;com.game.pileon;G;62;1345687890;1362895044;17207154;284.509.821.428.571
ravendyg/timetable-client;com.venomyd.timetable;G;62;1471773944;1489303488;17529544;289.840.343.915.344
AlecH92/DeskLights128.android;com.hilltoprobotics.desklights128.phone;G;62;1423079203;1457657531;34578328;571.731.613.756.614
peane/AukceadrazbyFragments;com.peanee.aukceadrazby;G;62;1416765491;1452940759;36175268;598.136.044.973.545
LvivAndroid/TestZNO;com.testterra.main;G;62;1324637260;1385688602;61051342;100.944.679.232.804
eboudrant/net.ebt.muzei.miyazaki;net.ebt.muzei.miyazaki;F;62;1403109437;1466010989;62901552;104.003.888.888.889
miguelvps/PoliteDroid;com.politedroid;F;62;1311274674;1424916427;113641753;187.899.723.875.661
learnopengles/Learn-OpenGLES-Tutorials;com.learnopengles.android;G;62;1306612469;1489415060;182802591;302.252.961.309.524
mesuk08/NFC-UTILS;com.nfcutils.app;G;63;1416721348;1422983223;6261875;103.536.292.989.418
covrom/PlanAndDoPro;pro.tsov.plananddopro;G;63;1453873171;1461471956;7598785;125.641.286.375.661
kaltura/kaltura-device-info-android;com.kaltura.kalturadeviceinfo;G;63;1463521581;1476772265;13250684;219.091.997.354.497
harism/android_instacam;fi.harism.instacam;G;63;1336938111;1365025354;28087243;464.405.472.883.598
CmdrStardust/Alite;de.phbouillon.android.games.alite;G;63;1442045167;1474069459;32024292;529.502.182.539.683
masanori840816/SearchWakayamaToilet;jp.searchwakayamatoilet;G;63;1432221748;1475063765;42842017;708.366.683.201.058
vishalkuo/philsTonight;com.philstonight;G;64;1442694728;1448216563;5521835;913.001.818.783.069
andynaguyen/Kisetsu;com.nguyen.andy.kisetsu;G;64;1467871152;1473827847;5956695;984.903.273.809.524
Csc-780/Profiler_project;com.evezzon.fakegps&amp;G;64;1442531091;1450682137;8151046;134.772.585.978.836
PET-EC-Sobral/BusTrackerMobile;ufc.pet.bustracker;G;64;1466484121;1493256562;26772441;442.666.021.825.397
panatoli/JNP-libgdx-Box2D;com.shval.springer;G;64;1364800280;1393019248;28218968;466.583.465.608.466
marcb1/droid-ssh;marc.scp.scp;G;64;1398813184;1449792767;50979583;842.916.385.582.011
KieranL/Winnipeg-Transit-Plus;com.kieran.winnipegbus;G;64;1438653968;1490756733;52102765;861.487.516.534.391
MausGames/disco-rock;at.mausgames.dr;G;64;1396718546;1491979731;95261185;157.508.573.082.011
Caolvxiong/Alien-Jump;com.wangwenchao.godown;G;65;1458332653;1463264472;4931819;815.446.263.227.513
zaneran/Weaths_up;zane.weaths_up;G;65;1475193538;1483489465;8295927;13.716.810.515.873
mcarri01/MusTrip;com.xeno.MusTrip;G;65;1473290153;1481669994;8379841;138.555.572.089.947
vNative/vnative-publisher-android;com.vnative.vnativepublisher;G;65;1482422925;1492746557;10323632;170.694.973.544.974
PiXeL16/Sea-Nec-IO;com.greenpixels.seanecio;G;65;1450151165;1467413822;17262657;285.427.529.761.905
daole/MySound;com.sastudio.mysound;G;65;1450617659;1468954300;18336641;303.185.201.719.577
macdidi5/PiCommander;net.macdidi5.picom;G;65;1426089706;1454123297;28033591;463.518.369.708.995
jkerb8/QwikStats;qwikstats.qwikcut.kerbysoft.com.qwikstats&amp;G;65;1462042366;1492300111;30257745;500.293.402.777.778
olejon/mdapp;net.olejon.mdapp;F;65;1419174484;1489013763;69839279;115.474.998.346.561
hitraj47/bit-day-live-wallpaper;com.bewareofraj.wallpaper.bitdaylivewallpaper;G;65;1388432896;1462661572;74228676;122.732.599.206.349
Amphoras/TPT-Helper;com.amphoras.tpthelper;F;65;1325522405;1405708113;80185708;132.582.189.153.439
marcopar/SliderSynth;eu.flatworld.android.slider;G;65;1392067512;1473450001;81382489;134.560.993.716.931
stephanepoinsart/votar;com.poinsart.votar;G;65;1363294869;1462913647;99618778;164.713.587.962.963
thibault/Napply;fr.miximum.napply;F;65;1298288571;1434005484;135716913;224.399.657.738.095
PradeepLoganathan/MovieMania;com.pradeeploganathan.moviemania;G;66;1473907734;1479120841;5213107;861.955.522.486.772
aayusht/seecret;com.seecret.mdb.seecret&amp;G;66;1479634819;1485396771;5761952;952.703.703.703.704
putin27/DinnerEatWhat;team26.fcu.dinnnereatwhat;G;66;1460810193;1470394878;9584685;15.847.693.452.381
SooperCode/PingApp_Demo;com.soopercode.pingapp;G;66;1427122023;1453557991;26435968;437.102.645.502.645
fython/Blackbulb;info.papdt.blackblub;F;66;1454303798;1485230895;30927097;511.360.730.820.106
demirciy/CalculateYgsLysScore;demirciy.ygslyspuanhesaplama;G;66;1455798928;1489480530;33681602;556.904.794.973.545
thelollies/MPC;thelollies.mpc;G;66;1361756679;1402448928;40692249;672.821.577.380.952
lucascudo/raulhc-app;cc.raulhc;G;66;1444054449;1493397798;49343349;815.862.251.984.127
robert7k/sipswitch;eu.siebeck.sipswitch;F;66;1339416222;1490346733;150930511;249.554.416.335.979
CODA-Masters/rocketman;com.codamasters.rocketdroid;G;67;1426369676;1434391003;8021327;132.627.761.243.386
tecnosys/litecoin-widget;org.phauna.litecoinwidget&amp;G;67;1364261911;1374951948;10690037;176.753.257.275.132
yolosec/upcKeygen;net.yolosec.upckeygen;G;67;1452088203;1467502892;15414689;254.872.503.306.878
davidru85/OpenWeather;com.davidru85.openweather;G;67;1383048485;1403429782;20381297;33.699.234.457.672
mikemilla/wordnerd-android;com.mikemilla.wordnerd;G;67;1427610460;1461811891;34201431;565.499.851.190.476
shahan312/princess-coloring-book-hd-android;com.gpasoftware.princess&amp;G;67;1355981574;1412818785;56837211;939.768.700.396.825
SDEagle/SudoQ;de.sudoq;F;67;1332944615;1442534256;109589641;181.199.803.240.741
watter/droid-datepicker;mikado.bizcalpro;G;68;1383684138;1392239016;8554878;141.449.702.380.952
j2deme/DataHabit;com.rdpharr.DataHabit;G;68;1333684122;1346007241;12323119;203.755.274.470.899
bpear/Nexus-4-Modem-Flasher;com.bpear.makomodem;G;68;1389823930;1419829752;30005822;496.128.009.259.259
PedroCarrillo/Expense-Tracker-App;com.pedrocarrillo.expensetracker;G;68;1442330482;1493345347;51014865;843.499.751.984.127
roys/java-android-developertools;com.roysolberg.android.developertools&amp;G;68;1434573530;1488046832;53473302;884.148.511.904.762
palfrey/postcode;net.tevp.postcode;F;68;1271956229;1491775990;219819761;363.458.599.537.037
lahi/RestaurantRecommandApp;com.soo.near.restaurant.app;G;69;1401675722;1407409856;5734134;948.104.166.666.667
juliettegonzalez/breakthrough-app;com.juliettegonzalez.breakthroughapp&amp;G;69;1481794286;1488488259;6693973;110.680.770.502.646
YLiohenki/GitHub-Contribute-Notifier;com.YLiohenki.AndroidGitHubContributeNotifier;G;69;1457084462;1464726019;7641557;12.634.849.537.037
kthomas1208/Capstone-Project;com.dreammist.foodwheel&amp;G;69;1473462272;1481779489;8317217;137.520.122.354.497
hgzojer/vocabletrainer;at.hgz.vocabletrainer;G;69;1405256877;1415345814;10088937;16.681.443.452.381
maartenvantjonger/derpcast;com.mvt.derpcast;G;69;1407530445;1432083336;24552891;405.967.113.095.238
wellingtonmb88/Aprovado;com.wellingtonmb88.aprovado;G;69;1432698233;1459696227;26997994;446.395.403.439.153
GiPiLab/simulateur-de-placements;org.gipilab.simulateurdeplacements;G;69;1456155423;1488829243;32673820;540.241.732.804.233
philburk/android-midisuite;com.mobileer.example.midiscope;G;69;1444776698;1484503513;39726815;656.858.713.624.339
aknkaplanoglu/Sportmix;tech.ozak.spormix;G;69;1444601092;1487447362;42846270;708.437.003.968.254
sakurabird/cocos2dx-BlockShooting;com.sakurafish.cocos2dx.brockshooting;G;69;1397372016;1460945218;63573202;105.114.421.296.296
maciekLato/RageTracksAndroid;com.macieklato.ragetracks;G;70;1391732687;1399760422;8027735;132.733.713.624.339
kawiniecki/Businesstrips;it.winiecki.businesstrip&amp;G;70;1477504628;1488109396;10604768;175.343.386.243.386
radimvaculik/LocusAddonGsakDatabase;net.kuratkoo.locusaddon.gsakdatabase;G;70;1323910156;1343564106;19653950;324.966.104.497.354
Vitaliy-Yakovchuk/ForeignReader;com.foreignreader;G;70;1376924045;1399648049;22724004;375.727.579.365.079
kinverarity1/librarything-browser;com.nietky.librarythingbrowser;G;70;1365507102;1392378257;26871155;444.298.197.751.323
andyli/BezelCursor;net.onthewings.bezelcursor;G;70;1372687916;1428928881;56240965;929.910.135.582.011
arthuryip723/CatholicBible;com.arthur.catholicbible;G;70;1369688007;1431650631;61962624;102.451.428.571.429
fjer/honeybadger;com.honeybadger;F;70;1338595325;1414614553;76019228;125.693.167.989.418
oranda/libanius-android;com.oranda.libanius;G;70;1377436913;1463931807;86494894;143.014.044.312.169
georgevarghese185/GlidePlayer;com.teefourteen.glideplayer;G;71;1476118620;1490801078;14682458;242.765.509.259.259
acbelter/app_list_widget;com.acbelter.applistwidget;G;71;1384204196;1402951206;18747010;309.970.403.439.153
ajindal2/Youtubemysongs;com.aanchal.youtubemysongs;G;71;1367164142;1395894976;28730834;475.046.858.465.608
brookman/vJoy;eu32k.vJoy;G;71;1359989584;1388771014;28781430;475.883.432.539.683
crvv/android_wubi_input;com.github.crvv.wubinput;G;71;1423707774;1486824686;63116912;104.359.973.544.974
danielpassos/call4paperz-android;com.call4paperz.android;G;71;1319126868;1403749624;84622756;139.918.578.042.328
iekumdario/SSPIA;com.fiec.ssapp;G;72;1397341571;1402899955;5558384;919.044.973.544.974
g-tanghe/CapitalBooze;com.tanghe.garben.capitalbooze;G;72;1470794102;1488275114;17481012;289.037.896.825.397
kirimin/Annictroid;me.kirimin.annictroid;G;72;1465327534;1489317076;23989542;39.665.248.015.873
wolfbytestudio/Tappers;org.tapper&amp;G;72;1449343894;1478698482;29354588;485.360.251.322.751
datakun/HarrisCam;com.main.harriscam;G;72;1352237297;1488420217;136182920;225.170.171.957.672
DeLaSalleUniversity-Manila/AndroidExercises;com.cabatuan.breastfriend;G;73;1444126553;1450655538;6528985;107.952.794.312.169
simonmullaney/Naloxalocate;com.apaulling.naloxalocate;G;73;1481139012;1489158812;8019800;132.602.513.227.513
andreamontanari/PlaceHolder;com.andreamontanari.placeholder;G;73;1466935915;1479233544;12297629;203.333.812.830.688
jeffrey-garcia/P2P-Project;hk.edu.polyu.P2pMobileApp;G;73;1457629971;1470458937;12828966;212.119.146.825.397
jgabrielfreitas/Flanelinha;br.com.manta.mantaray&amp;G;73;1420090494;1437425501;17335007;286.623.792.989.418
bvalosek/cpuspy;com.bvalosek.cpuspy;F;73;1301184437;1330362541;29178104;482.442.195.767.196
thibault/OpenQOTD;fr.miximum.qotd;F;73;1295537335;1331043020;35505685;587.064.897.486.772
boxhead201/PictureTrack;com.boxhead.android.picturetrack;G;73;1441636848;1490245014;48608166;803.706.448.412.698
dmide/DubnaBus;ru.ratadubna.dubnabus;G;73;1358273125;1424705358;66432233;109.841.655.092.593
heathbar/TheTVDB-Android;com.heath_bar.tvdb;G;73;1334984160;1412133274;77149114;127.561.365.740.741
lidavidm/music-practice-tools;com.proch.practicehub&amp;G;73;1315401782;1428180886;112779104;186.473.386.243.386
beefy/Stuur;com.stuur.stuur&amp;G;74;1453667376;1461804238;8136862;134.538.062.169.312
cmpickle/AshVin;com.pickle.ashvin;G;74;1481999160;1490751355;8752195;144.712.218.915.344
jholdstock/DecredWidgets;com.jamieholdstock.dcrwidgets;G;74;1462634575;1474125078;11490503;189.988.475.529.101
mhyhre/LightRabbit;mhyhre.lightrabbit;G;74;1435396613;1457730836;22334223;369.282.787.698.413
darrengyl/songsandhymnsoflife;com.church.psalm;G;74;1444186716;1467953441;23766725;392.968.336.640.212
MrNinja/NinjaLeanJapanese;gdg.nat.ninjalearnjapanese;G;74;1395920785;1438441192;42520407;703.049.057.539.683
tasomaniac/MuzeiEarthView;com.tasomaniac.muzei.earthview;G;74;1441657367;1488399787;46742420;772.857.473.544.974
Phantast/smartnavi;com.ilm.sandwich;F;74;1407159539;1480805020;73645481;121.768.321.759.259
surkovalexandr/geo;com.nextgis.mobile;G;74;1368735943;1459858447;91122504;150.665.515.873.016
mtotschnig/SendWithFtp;org.totschnig.sendwithftp;F;74;1336344263;1463956875;127612612;210.999.689.153.439
jakebasile/hearing-saver;com.jakebasile.android.hearingsaver;F;74;1291481667;1424369941;132888274;21.972.267.526.455
thunemn/Gates_Of_Logic;com.nathanthunem.gatesoflogic&amp;G;75;1467345674;1472856251;5510577;911.140.376.984.127
PadaliaRushabh/remembertocall;com.rushabh.remembertocall;G;75;1459569854;1466428446;6858592;113.402.645.502.645
mustafakuloglu/file-manager;gm.com.dosya&amp;G;75;1468309169;1476785486;8476317;140.150.744.047.619
JasonCromer/WhatsHappening;com.dev.cromer.jason.whatshappening;G;75;1442427984;1454479976;12051992;199.272.354.497.354
riaanjvos/etoll_logbook;za.co.etollgantrytracker;G;75;1421926694;1446024245;24097551;398.438.343.253.968
Mnkai/PGPClipper;moe.minori.pgpclipper;G;75;1443279787;1483416915;40137128;663.642.989.417.989
AlbertoCejas/GermanLearningUCA;es.uca.tabu;G;75;1385984353;1438528417;52544064;868.784.126.984.127
ldionmarcil/OSRSHelper;com.infonuascape.osrshelper;G;75;1410233069;1479772376;69539307;114.979.012.896.825
fedefernandez/MyAppList;com.projectsexception.myapplist;G;75;1334871344;1439211448;104340104;172.520.013.227.513
SimonMarquis/Android-SecretCodes;fr.simon.marquis.secretcodes;F;75;1379531500;1486289171;106757671;176.517.313.161.376
baolongnt/EmailPopup;com.blntsoft.emailpopup;G;75;1255099199;1383894074;128794875;212.954.489.087.302
hoang8f/AutoAP;info.hoang8f.autoap;G;76;1393237008;1414348944;21111936;349.073.015.873.016
c0d1ngb4d/vpn-toggle;com.codingbad.vpntoggle;G;76;1437357436;1458644100;21286664;351.962.037.037.037
jberkel/gist-it;com.zegoggles.gist;F;76;1305374152;1329773847;24399695;403.434.110.449.735
lolerpnv/OsijekNightlife;com.onl.osijeknightlife.app;G;76;1434746090;1464013958;29267868;483.926.388.888.889
tobykurien/BatteryFu;com.tobykurien.batteryfu;F;76;1391171743;1442842938;51671195;854.351.769.179.894
wbrenna/GTFSOffline;com.wbrenna.gtfsoffline;G;76;1386170384;1490843247;104672863;173.070.209.986.772
JA-VON/UWI-Research-Days-Android;com.uwics.uwidiscover;G;77;1455331247;1480465300;25134053;415.576.273.148.148
j0hnnys/MyWay;com.projects.johnny.myway;G;77;1454622854;1479952826;25329972;418.815.674.603.175
marcioapaiva/mocos-controlator;com.marcioapf.mocos;G;77;1341163071;1369965493;28802422;476.230.522.486.772
kconger/org.thecongers.sdrweather;org.thecongers.sdrweather;G;77;1390336412;1426538026;36201614;59.857.166.005.291
vikasdesale/PopularMovies;com.udacity.project2.mymovies;G;78;1481782058;1487435856;5653798;934.821.097.883.598
TomasKimer/gles3mark;com.tomaskimer.gles3mark;G;78;1394711410;1406452133;11740723;194.125.710.978.836
bees4honey/mobile_vin_scanner;com.bees4honey.vinscanner;G;78;1358165701;1491140101;132974400;219.865.079.365.079
lucys1/Hapened;me.hapened.hapened;G;79;1444246650;1453662360;9415710;155.683.035.714.286
peet29/Capstone-Project-part-2;me.hanthong.capstone;G;79;1466877018;1478058871;11181853;184.885.135.582.011
andromarina/yourRoute;com.yourRoute&amp;G;79;1366532717;1383394815;16862098;27.880.453.042.328
claha/movianremote;com.claha.showtimeremote;G;79;1413898777;1479904178;66005401;109.135.914.351.852
jamesgiang/AusSnowCam;com.jamesgiang.aussnowcam;F;80;1307462571;1312714408;5251837;868.359.292.328.042
jjshin85/pavement_android;com.pnpc.pavement;G;80;1456286671;1465939959;9653288;159.611.243.386.243
V-Play/PluginDemo;net.vplay.demos.PluginDemo;G;80;1461921101;1485381343;23460242;387.900.826.719.577
andrewkiluk/Mach-Music-Player;com.andrewkiluk.machmusicplayer;G;80;1389476843;1414346213;24869370;411.199.900.793.651
LabPLC/Traxi;codigo.labplc.mx.traxi&amp;G;80;1398806624;1435080604;36273980;599.768.187.830.688
axlecho/memo;axlecho.memo;G;80;1391664969;1441722064;50057095;827.663.607.804.233
saglave/spycam;spy.cam;G;80;1343253280;1398073669;54820389;906.421.775.793.651
AkhilNadendla/Wordsmith;com.shirtlessdan.andec.wordgamebeta&amp;G;80;1407547622;1475192558;67644936;111.846.785.714.286
geftimov/android-pathview;com.eftimoff.fonts;G;80;1421767266;1491818455;70051189;115.825.378.637.566
RaD/ando-gettext-editor;ru.securelayer.rad.ando;F;81;1330802021;1354362293;23560272;389.554.761.904.762
HenriqueKraemer/Ethanon-Engine;com.hardpixelgames.santasfactory;G;81;1395604090;1428023055;32418965;536.027.860.449.735
glowing-bear/glowing-bear-cordova;com.glowing_bear;F;81;1394478180;1476343755;81865575;13.535.974.702.381
wwSchrader/Peak_Fresh;com.wwschrader.android.peakfresh&amp;G;82;1472000453;1479073715;7073262;116.952.083.333.333
giginet/KawazJet;org.kawaz.KawazJet;G;82;1404869280;1438259804;33390524;552.091.997.354.497
JoelEager/Snake-2;com.byte_games.snake2;G;82;1389560153;1452398015;62837862;103.898.581.349.206
sketchpunk/opencomicreader;com.sketchpunk.ocomicreader;F;82;1347919522;1477875693;129956171;214.874.621.362.434
ItsSelina/tribbble;me.selinali.tribbble;G;83;1464488286;1469834245;5345959;883.921.792.328.042
randombyte-developer/SGLVertretungsplan;de.randombyte.sglvertretungsplan;G;83;1439574099;1448475796;8901697;147.184.143.518.519
taky/effy;com.gmail.altakey.effy;F;83;1316868370;1326518142;9649772;159.553.108.465.608
vishalkuo/pasteDump;pastedump.vishalkuo.com.pastedump;G;83;1431275871;1442167572;10891701;180.087.648.809.524
BattleShipPark/BSP-Gallery;com.battleshippark.bsp_gallery;G;83;1443072283;1483408206;40335923;666.929.943.783.069
ThibaudM/timelapse-sony;com.thibaudperso.sonycamera;G;83;1387697311;1477984764;90287453;149.284.809.854.497
nolanlawson/ChordReaderRoot;com.nolanlawson.chordreader;F;83;1282147760;1416697447;134549687;222.469.720.568.783
sreich/android-count-the-days;sreich.countthedays;G;84;1476026812;1488046572;12019760;198.739.417.989.418
samiuelson/android-stack-overflow-careers;me.urbanowicz.samuel.stackoverflowcareers;G;84;1456439979;1472645826;16205847;267.953.819.444.444
mikle9997/Course-work;com.mobirix.playmaze;G;84;1473496759;1492984688;19487929;322.221.048.280.423
Calega/CaronaUniversitaria;com.lucaoliveira.unicaroneiro&amp;G;84;1466319827;1488929036;22609209;373.829.513.888.889
kleitz/PepeSnap;com.jonathanrobins.pepe_snap&amp;G;84;1432361426;1457461584;25100158;41.501.583.994.709
mobiRic/FishHoekWeather;mobiric.fhbsc.weather;G;84;1391021050;1476706085;85685035;141.674.991.732.804
dmide/DubnaTaxi;ru.dmide.dubnataxi;G;84;1390338556;1481726178;91387622;151.103.872.354.497
TheFinestArtist/YouTubePlayerActivity;com.thefinestartist.ytpa.sample;F;84;1364292411;1467034324;102741913;169.877.501.653.439
scoutant/blokish;org.scoutant.blokish;G;84;1303374558;1486050941;182676383;302.044.284.060.847
FatBrownies/CinemaBase.github.io;com.cs499.mac.cinemabase;G;85;1428050724;1433333463;5282739;87.346.875
OpenMindBR/android-diversidade-app;br.edu.ifce.engcomp.francis.diversidade;G;85;1455885740;1477104170;21218430;350.833.829.365.079
armcha/Space-Navigation-View;com.google.android.apps.social.spaces;G;85;1470856239;1492186110;21329871;352.676.438.492.064
8tory/json2notification;com.story8.android.gallery;G;85;1425899895;1485559357;59659462;986.432.903.439.153
busradar/busradar;busradar.madison;G;85;1300943790;1491073197;190129407;314.367.405.753.968
xvang/bctn-tower-defense;com.padisDefense.game.android;G;86;1418428916;1426312338;7883422;130.347.585.978.836
aresen/morsms;com.ec.morsms;G;86;1354998233;1363474245;8476012;140.145.701.058.201
gecko655/earthquake;jp.gecko655.earthquake;G;86;1401328925;1411903993;10575068;174.852.314.814.815
dokgu/JoinDOTA;com.dokgu.joindota;G;86;1329330210;1350867091;21536881;356.099.222.883.598
marcosdiez/LimiteCartao;com.marcosdiez.extratocartao;G;86;1438527448;1485345942;46818494;774.115.310.846.561
romanchekashov/currency-and-stock-widget;ru.besttuts.stockwidget;G;86;1421747083;1489701442;67954359;11.235.839.781.746
cubei/FlappyCow;com.quchen.flappycow;F;86;1391960994;1474211879;82250885;135.996.833.664.021
machadaCosta/gathaba;fr.machada.gathaba;G;87;1447769449;1454506856;6737407;11.139.892.526.455
douglaslwong/Trackive;com.douglaswong.trackive;G;87;1443947675;1453357875;9410200;155.591.931.216.931
dconz13/Capstone-Project;com.conz13.d.strongpasswordcreator;G;87;1460570994;1470432187;9861193;163.048.826.058.201
cbpos1989/OffRoadTracker;cbpos1989.com.offroadtracker;G;87;1443439033;1453464225;10025192;16.576.044.973.545
omo/hiccup;es.flakiness.hiccup;G;87;1417213771;1431298597;14084826;232.884.027.777.778
railsstudent/VisitHeritage;com.blueskyconnie.visitheritage&amp;G;87;1388597031;1421774603;33177572;548.570.965.608.466
takke/DataStats;jp.takke.datastats;G;87;1423476538;1463228995;39752457;657.282.688.492.063
sathishmscict/android-flat-button;info.hoang8f.fbutton.demo;G;87;1399304914;1446025663;46720749;772.499.156.746.032
snow/sahara;cc.firebloom.sahara;G;87;1345468144;1428158617;82690473;136.723.665.674.603
nicopico-dev/dashclock-birthday;fr.nicopico.dashclock.birthday;G;87;1385212535;1475614648;90402113;149.474.393.187.831
trieu/i2tree;com.mc2ads.browser;G;87;1334161561;1428898489;94736928;156.641.746.031.746
Smerty/ham.android;com.smerty.ham;F;87;1273960391;1375567575;101607184;168.001.296.296.296
tobykurien/GoogleApps;com.tobykurien.google_news;G;87;1319724852;1440165696;120440844;199.141.607.142.857
FlightOfStairs/ADirStat;org.flightofstairs.ADirStat;G;88;1417223621;1425347200;8123579;134.318.435.846.561
bjerva/tsp-lexikon-android;com.bjerva.tsplex;G;88;1356098960;1364496380;8397420;13.884.623.015.873
yanniks/android_packages_apps_UpdateChecker;de.yanniks.cm_updatechecker;G;88;1361283793;1374672262;13388469;221.370.188.492.063
vaskort/react-native;com.locationsaver;G;88;1479157376;1492680056;13522680;223.589.285.714.286
intervigilium/Lame4Android;com.intervigil.lame;F;88;1287967831;1304388052;16420221;271.498.363.095.238
Collinux/Campus_Now;com.collinguarino.campus;G;88;1408382761;1448333885;39951124;660.567.526.455.026
ProjectSPAN/android-manet-manager;org.span;G;88;1343439508;1390794892;47355384;78.299.246.031.746
mofosyne/NFCMessageBoard;com.briankhuu.nfcmessageboard;G;88;1428037721;1479129414;51091693;844.770.056.216.931
Fortyseven/ToneDef;com.bytestemplar.tonedef;G;88;1397225689;1452989170;55763481;922.015.228.174.603
Dissem/Drupal-Editor;ch.dissem.android.drupal;G;88;1255777162;1400088426;144311264;238.609.894.179.894
jiparis/yadroid;org.andamobile.ashadow;G;88;1204232674;1435587957;231355283;382.531.883.267.196
JTechMe/JumpGo;com.jtechme.jumpgo;W;89;1451330956;1480366120;29035164;48.007.876.984.127
danielgimenes/NasaPic;br.com.dgimenes.nasapic;G;89;1435898080;1465412167;29514087;487.997.470.238.095
kyuuki/rensou-android-ADT;jp.kyuuki.rensou.android;G;89;1371129055;1426701082;55572027;918.849.652.777.778
ciubex/dscautorename;ro.ciubex.dscautorename;G;89;1396746601;1493640626;96894025;160.208.374.669.312
gwenhael-le-moine/IDontWannaWakeUpLikeCrap;com.gwenhael.idontwannawakeuplikecrap;G;90;1328990026;1345817387;16827361;27.823.017.526.455
jansoren/android-simple-gameapi;com.machinegames.othello;G;90;1350321287;1376999224;26677937;441.103.455.687.831
1gravity/Android-ContactPicker;com.onegravity.contactpicker.demo;G;90;1463429267;1490107842;26678575;44.111.400.462.963
Bradsta/Spy-Maze;com.spymaze&amp;G;90;1447473509;1475128680;27655171;45.726.142.526.455
brandaogabe/StarfieldScreensaver;com.skytrait.spacedream&amp;G;90;1455756955;1484619995;28863040;477.232.804.232.804
v1k/palabras;com.mates120.myword;G;90;1370822494;1415412910;44590416;737.275.396.825.397
andrew6000/NYLotto;nyc.stmarkssolutions.lottery.app&amp;G;90;1427952049;1493004158;65052109;107.559.704.034.392
abcdjdj/RootVerifier-APP;com.abcdjdj.rootverifier;F;90;1375440985;1459253578;83812593;13.857.902.281.746
Softcatala/LanguageToolAndroidService;org.softcatala.corrector;G;90;1403643182;1487793767;84150585;13.913.787.202.381
wescratty/GPS2Master;edu.umontana.derivio;G;91;1455821298;1463166241;7344943;121.444.163.359.788
svu/UkeWatch;ie.udaltsoft.musicwatch;G;91;1436055568;1493333202;57277634;947.050.826.719.577
chartsai/FileController;com.cha122977.android.filecontroller&amp;G;91;1333391038;1399494614;66103576;109.298.240.740.741
qtao913/PopularMovies;com.sunnietech.hotflicks;G;92;1450152647;1460525141;10372494;171.502.876.984.127
StefanPahlplatz/shopping-list;s.pahlplatz.shoppinglist;G;92;1479812404;1493482080;13669676;226.019.775.132.275
AmrutSai/sikuna;uk.org.rivernile.edinburghbustracker.android;G;92;1388078489;1411296506;23218017;383.895.783.730.159
nikolaychernov/SamaraTransport;com.nikolaychernov.samaratransport;G;92;1426795195;1452970109;26174914;432.786.276.455.026
andrewfang/ListenUp;edu.berkeley.cs160.jaguars.listenup;G;92;1395362789;1421967472;26604683;43.989.224.537.037
Smerty/zooborns.android;org.smerty.zooborns;F;92;1278263546;1320568182;42304636;699.481.415.343.915
PerformanceHorizonGroup/measurementkit-android;com.performancehorizon.exactview&amp;G;92;1442848690;1488876570;46027880;761.042.989.417.989
rulogarcillan/SignatureMaker;com.signaturemaker.app;F;92;1427728012;1480252165;52524153;868.454.910.714.286
Jawnnypoo/PhysicsLayout;com.jawnnypoo.physicslayout.sample;G;92;1428643946;1487347880;58703934;970.633.829.365.079
emmaguy/PocketWidget;dev.emmaguy.pocketwidget;G;92;1372848367;1439127198;66278831;109.588.014.219.577
loadrunner/wmg-android;ro.weednet.wmg;G;92;1326040390;1392574675;66534285;110.010.391.865.079
easytargetmixel/micopi_android;com.easytarget.micopi;G;92;1398099185;1488050434;89951249;148.728.916.997.355
ZNS/comicdroid;com.zns.comicdroid;G;93;1354640697;1381142681;26501984;43.819.417.989.418
OnlyInAmerica/BART;pro.dbro.bart;F;93;1331773791;1390615063;58841272;97.290.462.962.963
onyxbits/remotekeyboard;de.onyxbits.remotekeyboard;F;93;1369689133;1468969152;99280019;164.153.470.568.783
cody82/sigfood;de.sigfood;F;93;1333759479;1476222043;142462564;235.553.181.216.931
fadelakin/vortex;com.fisheradelakin.vortex;F;94;1421293183;1430154097;8860914;146.509.821.428.571
Goddchen/GuildWars2-API-Explorer;de.goddchen.android.gw2.api;G;94;1369217696;1414271940;45054244;744.944.510.582.011
ajayyy/SteamworksScoutingApp;ca.lakeeffect.scoutingapp;G;95;1474408577;1492722029;18313452;302.801.785.714.286
mnishiguchi/MovingEstimator;com.mnishiguchi.android.movingestimator;G;95;1417221100;1442770252;25549152;422.439.682.539.683
leszko/how-far;com.summercoding.howfar;G;95;1400004352;1434093400;34089048;563.641.666.666.667
wakhub/monodict;com.github.wakhub.monodict;G;95;1403534353;1452310029;48775676;806.476.124.338.624
jonfinerty/Once;jonathanfinerty.onceexample;G;95;1435765605;1491248983;55483378;917.383.895.502.646
OldSkoolMark/BravuraBrowser;com.sublimeslime.android.bravurabrowser&amp;G;96;1396395809;1412028993;15633184;258.485.185.185.185
mxrguspxrt/aabitsaraamat;ee.aabitsaraamat.www;G;96;1374400879;1401752278;27351399;452.238.740.079.365
primetime00/PalaceGame;com.kegelapps.palace.android&amp;G;96;1449592682;1478634453;29041771;480.188.012.566.138
lubomyr/GlobalTv-Android;org.videolan.vlc;G;96;1454107728;1489849937;35742209;590.975.677.910.053
tprzepiorka/signaltracker;tprz.signaltracker;G;96;1416354452;1463003087;46648635;771.306.795.634.921
rpi-mobile/RPIMobile-Android;edu.rpi.rpimobile;G;96;1382657629;1447452536;64794907;107.134.436.177.249
christarazi/btcapp;app.CT.BTCCalculator;G;96;1393985234;1487804462;93819228;155.124.384.920.635
tobiasschuerg/Expenses-Android;com.tobiasschuerg.expenses;G;96;1344550289;1483874976;139324687;230.364.892.526.455
dblaber/urlminimizer;org.da4.org.urlminimizer.android.client;F;97;1476237190;1481606716;5369526;887.818.452.380.952
The1andONLYdave/Project-Montezuma;com.dlka.projectmontezuma;G;97;1406466158;1413364501;6898343;114.059.904.100.529
asksven/BetterBatteryStats;com.asksven.betterbatterystats;F;97;1481799659;1493757530;11957871;197.716.121.031.746
wanleung/Stroke5Keyboard-android;com.linkomnia.android.Stroke5;F;97;1330097838;1346659436;16561598;273.835.945.767.196
kakakikikeke/FlappyXY;com.blogspot.kakakikikeke.sensortest;G;97;1441083812;1467089294;26005482;429.984.821.428.571
niso217/OpenSSME;com.open.ssme&amp;G;97;1463077143;1489582152;26505009;438.244.196.428.571
danthe96/CircleTheDog_public;com.danthe.dogeescape;G;97;1414784047;1442421297;27637250;456.965.112.433.862
DavidWigley/WITRoomFinder;wigleyd.witroomfinder&amp;G;97;1450145465;1485542915;35397450;585.275.297.619.048
bestan/android-wear-expense-tracker;lv.bestan.android.wear.expensestracker;G;97;1404506862;1466873109;62366247;103.118.794.642.857
mawis/sailtrainer;eu.wimmerinformatik.sbfb;G;97;1333915815;1451326686;117410871;194.131.731.150.794
lolapriego/cobrador_del_frac;com.lolapau.cobradordelfrac&amp;G;98;1367060416;1394670782;27610366;456.520.601.851.852
M66B/FineGeotag;eu.faircode.finegeotag;F;98;1431009642;1461740110;30730468;50.810.958.994.709
PeterChu2/Tweet-Offline;chu.ForCHUApps.tweetoffline;G;98;1405869227;1440485685;34616458;57.236.207.010.582
olyv/WortschatzGradle;com.olyv.wortschatz.ui;G;98;1421846264;1491042997;69196733;114.412.587.632.275
ofelbaum/spb-transport-app;com.emal.android.transport.spb;G;98;1334039232;1413446441;79407209;131.294.988.425.926
Gark/bassblog_kotlin;pixel.kotlin.bassblog;G;99;1476133533;1481125436;4991903;825.380.787.037.037
Crazywater/knufficast;de.knufficast;G;99;1348960808;1360427039;11466231;189.587.152.777.778
zagayevskiy/Pacman;com.zagayevskiy.pacman;G;99;1353246557;1380381015;27134458;448.651.752.645.503
gi097/MijnWindesheim;com.giovanniterlingen.windesheim;G;99;1456667807;1490171217;33503410;553.958.498.677.249
dmsl/anyplace;com.dmsl.anyplace;G;99;1440664784;1493127042;52462258;867.431.514.550.264
vzaliva/sbautologin;org.crocodile.sbautologin;G;99;1300992183;1427504911;126512728;209.181.097.883.598
nonamejx/GrammarX;com.nonamejx.grammarx;G;100;1469418464;1475936405;6517941;107.770.188.492.063
PuZZleDucK/Orbital-Live-Wallpaper;orbitlivewallpaperfree.puzzleduck.com;F;100;1335342774;1349502068;14159294;234.115.310.846.561
azmikemm/ZeoCompanion;opensource.zeocompanion&amp;G;100;1462552208;1477462507;14910299;246.532.721.560.847
Fck-r-sns/AvalonSchedule;com.binary_machinery.avalonschedule&amp;G;100;1457726386;1490127749;32401363;535.736.822.089.947
puru2u/Mongo;com.innodroid.mongobrowser;G;100;1349222825;1446659825;97437000;161.106.150.793.651
bishopmatthew/HackerNews;com.airlocksoftware.hackernews;F;100;1359565120;1472137452;112572332;186.131.501.322.751
babramovitch/ShambaTimes;com.shambatimes.schedule;G;101;1439744948;1469845411;30100463;497.692.840.608.466
dkonayuki/9Fun;net.jstudio.gagfun;G;101;1331338458;1389201454;57862996;956.729.431.216.931
whily/calendarlookup;net.whily.android.calendarlookup;G;101;1424411896;1488613193;64201297;106.152.938.161.376
graham22/Classic;ca.farrelltonsolar.classic;G;101;1417463411;1485707302;68243891;112.837.121.362.434
luocaca/TelephonyDemo;teaonly.droideye;G;101;1343253280;1430991277;87737997;145.069.439.484.127
ToYonos/hfr4droid;info.toyonos.hfr4droid;G;101;1282496570;1429886115;147389545;243.699.644.510.582
madeye/proxydroid;org.proxydroid;F;101;1327649481;1480905557;153256076;253.399.596.560.847
amanjpro/splittimer;me.amanj.splittimer;G;102;1470752319;1480181099;9428780;15.589.914.021.164
HexTree/red-sea-tools;kaust.orientationapp&amp;G;102;1432414565;1449666851;17252286;285.256.051.587.302
danielfmsouza/Teleprompter;com.easyapps.teleprompter;G;102;1469999308;1491092873;21093565;348.769.262.566.138
diegoponciano/biblia-ccb;com.cubolabs.bibliaofflinearc;G;102;1410788004;1451408141;40620137;671.629.249.338.624
JerabekJakub/LocusAddonGeogetDatabase;net.kuratkoo.locusaddon.geogetdatabase;G;102;1322487982;1396861896;74373914;122.972.741.402.116
rjmarsan/PlasmaSound;com.rj.processing.plasmasound;F;102;1294812200;1382833319;88021119;145.537.564.484.127
edsonduarte1990/reminders;com.lostrealm.lembretes;F;102;1387806909;1485126621;97319712;160.912.222.222.222
JonLatane/ChordCalcComposer;com.jonlatane.composer;G;102;1337205556;1473976599;136771043;22.614.259.755.291
soulwraith/thirtydays;com.challenge.bennho.a30days;G;103;1482129054;1488287034;6157980;101.818.452.380.952
HabeebAhmed1234/WakeyWakey;com.wakeywakey2.alarmclock&amp;G;103;1426621441;1442284916;15663475;258.986.028.439.153
maakashdeep/SensorDashboard;com.github.pocmo.sensordashboard;G;103;1414850857;1483630014;68779157;113.722.151.124.339
2Canton/Carriot-Android;com.nansoft.mipuribus;G;104;1442796854;1458102929;15306075;253.076.636.904.762
giginet/KawazCatch;org.kawaz.KawazCatch;G;104;1400142648;1417061028;16918380;279.735.119.047.619
holylobster/nuntius-android;org.holylobster.nuntius;G;104;1425405642;1468044305;42638663;705.004.348.544.974
jakkra/Transit;se.jakobkrantz.transit.app;G;104;1416252294;1488032096;71779802;11.868.353.505.291
marioloncar/STEMI-Android;com.stemi.STEMIHexapod;G;105;1457613374;1492102901;34489527;570.263.343.253.968
liquid36/CuandoLlegaAndroid;com.samsoft.cuandollega;G;105;1410832949;1476320285;65487336;108.279.325.396.825
opensystemsassociation/southendtransportresearch;ioio.example.ioiohardwaretester&amp;G;106;1363016165;1375132483;12116318;200.335.945.767.196
UberPay/uberpay-wallet;com.wStartChat;G;106;1440348333;1458831018;18482685;305.599.950.396.825
dapathy/giant_fleece_blanket;edu.gonzaga.textsecretary&amp;G;106;1413079779;1436052687;22972908;379.843.055.555.556
gioRodriguez/sdEncuentro;com.sd.encuentrocatorce&amp;G;106;1389283131;1417821786;28538655;471.869.295.634.921
Ahmed-Emad/Elmod;io.zarda.elmod;G;106;1430744191;1478199315;47455124;7.846.416.005.291
youkaithegreat/CodeClicker;com.kevintyang.codeclicker.codeclicker&amp;G;106;1404853556;1455068031;50214475;830.265.790.343.915
antoniy/Gidder;net.antoniy.gidder.beta;G;106;1323005476;1424291531;101286055;167.470.329.034.392
ky200223/bluetoothViewer;net.bluetoothviewer;G;106;1285669236;1402321866;116652630;192.878.025.793.651
PeterChu2/Trendy;com.forchuapps.uofthacks.trendy;G;107;1422682795;1431480098;8797303;145.458.052.248.677
sudochownrwhoami/FoodTruckAficionadosOpenSource;com.justin.freetruckfinder.app;G;107;1395058511;1407451023;12392512;204.902.645.502.646
yefengfreedom/HiRecyclerView;com.freedom.yefeng.yfrecyclerview.example;G;107;1437734046;1489498354;51764308;855.891.335.978.836
Tok11313/MySimoneRepository;com.twotoasters.jazzylistview.sample;G;107;1366080469;1425332024;59251555;979.688.409.391.534
andhikai/ferticalc;de.arnowelzel.android.periodical;G;107;1341385306;1439648566;98263260;162.472.321.428.571
ghisguth/sunlight;cxa.lineswallpaper;F;107;1352343455;1468820597;116477142;192.587.867.063.492
harism/android_lucidchat;fi.harism.lucidchat;G;108;1339543380;1361983860;22440480;371.039.682.539.683
team0n3/Project-Holiday;com.YRH.PackPoint;G;108;1432029737;1460401957;28372220;469.117.394.179.894
edwise/DedicaMNS;com.edwise.dedicamns;G;108;1344790675;1412105519;67314844;111.300.998.677.249
omerjerk/RemoteDroid;in.umairkhan.remotedroid;G;108;1405931537;1478769793;72838256;120.433.624.338.624
poliva/radare-installer;org.radare.installer;G;108;1333248430;1415606138;82357708;136.173.458.994.709
jackpf/BlockchainSearch;com.jackpf.blockchainsearch;F;109;1392822580;1401460128;8637548;142.816.600.529.101
FalconerTC/BuffBusApp-android;com.cherish.BusTracker;G;109;1437338238;1481308538;43970300;727.022.156.084.656
cadeli/CdlUI;com.cadeli.dmFree;G;109;1373295250;1429256882;55961632;925.291.534.391.534
evisong/noodlesmaster;me.evis.mobile.noodle;G;109;1286670158;1410304932;123634774;204.422.576.058.201
gurrhack/NetHack-Android;com.tbd.NetHack;F;109;1307555017;1470253423;162698406;26.901.191.468.254
pecheny/score-store;com.shoo;G;110;1377885466;1384271308;6385842;105.586.011.904.762
khuongthai/Iknow;team.kyb&amp;G;110;1381782107;1390585146;8803039;145.552.893.518.519
spirosbond/CallerFlashlight;com.spirosbond.callerflashlight&amp;G;110;1378311480;1390927382;12615902;208.596.263.227.513
spirosbond/CallerFlashlight;com.spirosbond.callerflashlight;F;110;1378311480;1390927382;12615902;208.596.263.227.513
ezh/android-component-DigiSSHD;org.digimead.digi.ctrl.sshd;F;110;1328730327;1342373790;13643463;225.586.359.126.984
kimjisoo/ForceDoze;com.suyashsrijan.forcedoze&amp;G;110;1462972350;1489493041;26520691;438.503.488.756.614
guaka/mediawikixml2meteor2phonegap;io.cordova.cordovahitchwikimeteorcom;G;110;1363217543;1411205954;47988411;793.459.176.587.302
PuzzleboxIO/jigsaw-android;io.puzzlebox.jigsaw.android;G;110;1429606803;1478384851;48778048;806.515.343.915.344
manuelnaranjo/AndroidBluetoothLowEnergyEnabler;com.manuelnaranjo.btle.installer2;G;110;1346273486;1440554933;94281447;155.888.635.912.698
agwells/dotdash-keyboard-android;net.iowaline.dotdash&amp;G;110;1326099929;1450348135;124248206;205.436.848.544.974
sababado/McPubs;com.sababado.mcpubs;G;111;1472165817;1478217848;6052031;100.066.650.132.275
camtaylor/LockDoc;com.rekap.lockdoc&amp;G;111;1413847342;1426733976;12886634;213.072.652.116.402
asafge/PocketPlus;com.asafge.pocketplus;G;111;1375028536;1419142787;44114251;729.402.298.280.423
nicolassmith/urlevaluator;com.github.nicolassmith.urlevaluator;G;111;1359655902;1414287144;54631242;903.294.345.238.095
hgzojer/picturetrainer;at.hgz.picturetrainer;G;111;1405256877;1487501463;82244586;135.986.418.650.794
onyxbits/listmyaps;de.onyxbits.listmyapps;F;112;1377742218;1411762029;34019811;562.496.875
matt-allen/repay-android;com.repay.android;G;112;1396720720;1465920386;69199666;114.417.437.169.312
samuelpratt/Sudoku;uk.co.samuelpratt.sudoku;G;113;1481136324;1486331683;5195359;859.020.998.677.249
ThoughtWorksAustralia/AndroidBootcampProject;com.magix.camera_mx;G;113;1387434168;1401699232;14265064;235.864.153.439.153
BennetBartmann/Jinawa;de.bb42.jinawapremium;G;113;1411397854;1428587258;17189404;284.216.335.978.836
manuel-palacio/CNG-Stations;net.palacesoft.cngstation&amp;G;113;1341435687;1370441892;29006205;479.599.950.396.825
NorthernStars/NAO-Com;de.robotik.nao.communicator;G;113;1394007710;1445090901;51083191;844.629.480.820.106
philwade/Interflix;org.philwade.android.interflix;G;113;1275333422;1333058213;57724791;954.444.295.634.921
petrows/RK3066-Headunit-service;com.petrows.mtcservice;G;113;1413053262;1489223032;76169770;125.942.080.026.455
daole/MedicineNotebook;com.dreamdigitizers.medicinenote;G;114;1444665273;1468957953;24292680;401.664.682.539.683
crust87/Android-ImageCropper;com.crust87.imagecropper;G;114;1432029210;1456969320;24940110;412.369.543.650.794
M8yMax/IRRemote;org.twinone.irremote;G;114;1400583325;1426841954;26258629;434.170.453.042.328
xperia64/timidity-ae;com.xperia64.timidityae;G;114;1409613055;1491534107;81921052;135.451.474.867.725
manosim/gitify-mobile;com.gitify;G;115;1465376284;1473981381;8605097;142.280.042.989.418
johnnylambada/WorldMap;com.sigseg.android.worldmap;G;115;1334076358;1401303250;67226892;111.155.575.396.825
kriben/Bussan;no.kriben.bussan;G;115;1311101413;1426679828;115578415;191.101.876.653.439
dyouyang/D3Quests;com.dyo.d3quests;G;116;1394244687;1402126163;7881476;13.031.541.005.291
kurtmc/MyEarnings;com.mcalpinedevelopment.calculatepay&amp;G;116;1375145193;1446698584;71553391;118.309.178.240.741
ratty3697/android-smart-animation-library;com.podcopic.animationlib.androidsimplifiedanimation&amp;G;117;1443840346;1471632363;27792017;459.524.090.608.466
fvasco/pinpoi;io.github.fvasco.pinpoi;G;117;1451913626;1493112000;41198374;681.190.046.296.296
adrian-bl/bl-battstatus-android;ch.blinkenlights.battery;F;117;1303555750;1416251611;112695861;186.335.749.007.936
banasiak/CoinFlip;com.banasiak.coinflip;G;117;1305599268;1475028552;169429284;280.141.011.904.762
EricKirschenmann/Fireline;com.erickirschenmann.fireline;G;118;1488607877;1493689548;5081671;84.022.337.962.963
SunyataZero/KindMind;com.sunyata.kindmind;G;119;1378635085;1468618628;89983543;148.782.313.161.376
douzifly/clear-todolist;douzifly.list;G;120;1444285306;1469599107;25313801;418.548.296.957.672
feresr/RxWeather;com.feresr.weather;G;120;1444074752;1471148093;27073341;447.641.220.238.095
anselm94/Torchie-Android;in.blogspot.anselmbros.torchie;F;120;1453087195;1490365013;37277818;616.366.038.359.788
fiskurgit/FloodMonitoring;eu.fiskur.floodmonitor;G;121;1447147098;1480953054;33805956;558.960.912.698.413
Kernald/buildbot-watcher;com.buildbotwatcher;G;121;1328369566;1368183882;39814316;658.305.489.417.989
hongsenliu/chinese-checkers;org.scoutant.cc;G;122;1309183676;1354724585;45540909;752.991.220.238.095
jonas14159/SpeedcubeTimer;com.speedcubeapp.timer;G;123;1428430453;1433339566;4909113;811.691.964.285.714
VictorPurMar/Safegees;org.safegees.safegees;G;123;1451325654;1476269511;24943857;412.431.498.015.873
JakubDziworski/BumpRace;com.frontmob.bumpracerelease;G;123;1405065063;1469989640;64924577;107.348.837.632.275
rafali/flickr-uploader;com.rafali.flickruploader2;G;123;1363574225;1445703100;82128875;13.579.509.755.291
sticksoft/ADCPU-16Emu;uk.co.sticksoft.adce;G;124;1333581844;1360279040;26697196;441.421.891.534.392
thercode/MCPE-ADDON;com.mrcrayfish.furnitureinstaller;G;124;1398925347;1434466181;35540834;587.646.064.814.815
ctopheryoung/Foos-Android;xyz.chrisyoung.foos;G;125;1461340215;1466790910;5450695;901.239.252.645.503
Rouji/Hupl;eu.imouto.hupl;G;125;1462331905;1493365510;31033605;513.121.775.793.651
Utyff/pMetro;com.utyf.pmetro;G;125;1439051096;1488644660;49593564;819.999.404.761.905
waynepiekarski/android-glider;net.waynepiekarski.glider;G;125;1405117608;1469667535;64549927;106.729.376.653.439
chenjishi/usite;com.chenjishi.u148&amp;G;125;1351929191;1493802548;141873357;234.578.963.293.651
DHBWLoerrach/CampusApp;de.dhbwloe.loerrach.campusapp;G;126;1477930961;1492008030;14077069;232.755.770.502.646
Simon-Raes/Dota-Data-Old;be.simonraes.dotadata;G;126;1391625075;1410093513;18468438;305.364.384.920.635
zamojski/TowerCollector;info.zamojski.soft.towercollector;G;126;1456773451;1477911152;21137701;349.499.024.470.899
joan-domingo/Podcasts-RAC1-Android;cat.xojan.random1;G;126;1467502086;1491335269;23833183;394.067.179.232.804
b0wter/ETA;de.roughriders.jf.eta;G;127;1465587004;1492023946;26436942;43.711.875
sureshs592/where-is-my-cash;com.suresh.whereismycash;G;127;1379054952;1419197792;40142840;663.737.433.862.434
BlokusGame/BlokusDuo;blokusgame.mi.android.hazi.blokus;G;128;1413887606;1426356684;12469078;206.168.617.724.868
cpinan/BTEndlessTunnel;c;G;128;1396560375;1421882688;25322313;418.689.037.698.413
bmarrdev/android-DecoView-charting;com.hookedonplay.decoviewsample;G;128;1438681321;1468034030;29352709;485.329.183.201.058
jcasson/MeerkatChallenge;eu.johncasson.meerkatchallenge;G;128;1378548227;1408796972;30248745;500.144.593.253.968
SpazeDog/mounts2sd;com.spazedog.mounts2sd;F;128;1371981060;1405431189;33450129;553.077.529.761.905
saschier/fhp-eduroam;uk.ac.swansea.eduroamcat;G;128;1457432293;1492170744;34738451;574.379.150.132.275
Raxa/doctorsnearme;com.raxa.EMR&amp;G;129;1400068947;1408453382;8384435;138.631.531.084.656
abassawo/Ecquo;abassawo.c4q.nyc.ecquo;G;129;1439155988;1448418336;9262348;153.147.288.359.788
jamesmorrisstudios/Randomly-RemindMe;jamesmorrisstudios.com.randremind;G;129;1429546305;1444784591;15238286;251.955.787.037.037
foxanna/SimpleLocationAlarm;simplelocationalarm.droid;G;129;1410108287;1460127479;50019192;827.036.904.761.905
Adonai/Man-Man;com.adonai.manman;F;129;1414145017;1493639879;79494862;131.439.917.328.042
JohnNPhillips/HistoryCleanerPro;com.ayros.historycleaner;G;129;1396232676;1491174248;94941572;156.980.112.433.862
petrkle/tabulka;cz.kle.tabulka;G;129;1362328497;1491588726;129260229;213.723.923.611.111
denisk20/bullshit-bingo-champion;com.denisk.bullshitbingochampion;G;130;1405774876;1433864427;28089551;464.443.634.259.259
rrtigga/GetDisciplined;com.spicycurryman.getdisciplined10.app;G;131;1402281647;1436258996;33977349;561.794.791.666.667
JoshuaChing/jPlayer;com.jchingdev.jplayer;G;131;1390196036;1440642448;50446412;834.100.727.513.228
davidschwegler/lfnw;com.appenjoyment.lfnw;G;131;1366529611;1461652016;95122405;157.279.108.796.296
florianmski/Traktoid;com.florianmski.tracktoid;F;131;1319658310;1425947694;106289384;175.743.029.100.529
LeBeam/CrazyWords;com.bravolang.phrasebook;G;132;1398670632;1405646785;6976153;11.534.644.510.582
ktrnka/droidling;com.github.ktrnka.droidling;G;132;1355980073;1414384234;58404161;96.567.726.521.164
meisterfuu/Animexx-Android-App;de.meisterfuu.animexx;G;132;1333303530;1421612821;88309291;146.014.039.351.852
ChrisGaddes/Reaction;com.chrisgaddes.reaction;G;133;1466111868;1474141491;8029623;132.764.930.555.556
jareddlc/OpenFit;com.solderbyte.openfit;F;133;1421533263;1475989143;54455880;900.394.841.269.841
marcopar/SDOViewer;eu.flatworld.android.sdoviewer;G;133;1424643196;1489095777;64452581;106.568.420.965.608
Thonners/CrosswordMaker;com.thonners.crosswordmaker;G;133;1418243337;1487282467;69039130;114.152.000.661.376
chrispbailey/ToDo-List-Widget;org.chrisbailey.todo;F;134;1276208269;1294571354;18363085;303.622.437.169.312
bleissem/babyphone;com.bleissem.babyphone;G;134;1430161678;1489966300;59804622;988.833.035.714.286
balesz/android-WebSearch;net.solutinno.websearch;G;134;1374143687;1441201588;67057901;110.876.159.060.847
ValleZ/Paper-Wallet;ru.valle.btc;G;134;1374014663;1491704185;117689522;194.592.463.624.339
Gear61/PADFriendFinder-Android;com.randomappsinc.padfriendfinder;G;135;1436851480;1461220575;24369095;402.928.158.068.783
OrdonTeam/HackZurich;com.ordonteam.shoutify&amp;G;136;1412068255;1421802490;9734235;160.949.652.777.778
stackunderflow-stackptr/stackptr_android;com.stackunderflow.stackptr;G;136;1382246282;1461152616;78906334;130.466.822.089.947
soulwraith/pandt2;com.mygdx.potatoandtomato.android;G;137;1448946232;1488287146;39340914;650.478.075.396.825
IncineratorG/Costs;com.touristskaya.expenses;G;137;1448209752;1493745891;45536139;752.912.351.190.476
intrications/intent-intercept;uk.co.ashtonbrsc.android.intentintercept;F;138;1338463546;1471617900;133154354;220.162.622.354.497
phealeyh/tracking-application;tracking.id11723222.com.trackingapplication;G;140;1446543823;1482989657;36445834;602.609.689.153.439
harsimrans/CrowdSource;com.mantz_it.rfanalyzer;G;140;1412916953;1491284505;78367552;129.575.978.835.979
evanklein1/Grade-Calculator;me.evanklein.finalexamcalculator;G;141;1446785207;1451790557;5005350;827.604.166.666.667
dougblack/nextbus;com.doug.nextbus;G;141;1330484623;1366035011;35550388;587.804.034.391.534
jamesonwilliams/pixphony;org.nosemaj.pixphony;G;141;1407893473;1466749692;58856219;973.151.769.179.894
efidroid/android_app_efidroidmanager;org.efidroid.efidroidmanager;F;142;1452100171;1490816082;38715911;640.144.031.084.656
gorbin/ASNE;com.gorbin.androidsocialnetworksextended.asne;F;142;1406789090;1484022438;77233348;127.700.641.534.392
dyne/ZShaolin;org.dyne.zshaolin;G;142;1327163857;1419202348;92038491;152.180.044.642.857
glasgowneuro/AttysScope;tech.glasgowneuro.attysscope2;G;143;1471383975;1489970743;18586768;307.320.899.470.899
nelze/singkamas;usbong.android.questionloader&amp;G;144;1426210967;1439864053;13653086;22.574.546.957.672
soulwraith/ffinder;com.ffinder.android;G;144;1473780375;1488286859;14506484;239.855.886.243.386
jaapaurelio/duck-escape;com.creativebackyard.duckescape;G;145;1415053440;1475927262;60873822;100.651.160.714.286
CiTuX/TD;ch.citux.td;F;145;1358955731;1475328820;116373089;192.415.821.759.259
ioBroker/ioBroker.vis.cordova;net.iobroker.vis&amp;G;146;1450618189;1493792074;43173885;713.853.918.650.794
schlaf/WHAC_by_slaforet;com.schlaf.steam;G;146;1421957659;1490907137;68949478;114.003.766.534.392
MAVProxyUser/NoTauLabsNag;org.openpilot.androidgcs;G;147;1395670762;1409879868;14209106;234.938.921.957.672
NickIliev/NativeScript-Cosmos-Databank;org.nativescript.curiosity&amp;G;147;1471430137;1487682307;16252170;268.719.742.063.492
orenyodfat/lbm-client;com.lazooz.lbm&amp;G;147;1404399613;1421580062;17180449;284.068.270.502.645
vishalkuo/FuturesRevealed;vishalkuo.com.futuresrevealed;G;147;1425359669;1443553779;18194110;300.828.538.359.788
chris-kobrzak/lewica-pl-android;pl.lewica.lewicapl&amp;G;147;1318636014;1407512005;88875991;146.951.043.320.106
sj6257/Streetfood-Android;com.dev.streetfood&amp;G;147;1359825344;1479264867;119439523;197.485.983.796.296
j1angvei/CB-News;cn.j1angvei.cbnews;G;148;1467609064;1476048710;8439646;139.544.411.375.661
Trellmor/BerryTube;com.trellmor.berrytubechat;G;148;1351028174;1472932041;121903867;201.560.626.653.439
NeelkanthDabhi/Wrapper;me.neelkanth.social.app;G;150;1461603617;1493220199;31616582;522.760.945.767.196
nihk/Java-Music;com.nihk.github.musictheoryromannumeralanalysisquiz;G;150;1435053806;1474333765;39279959;649.470.221.560.847
krrishnarraj/clpeak;kr.clpeak;G;150;1377441499;1492192461;114750962;189.733.733.465.608
OnlyInAmerica/GlanceReader;pro.dbro.openspritz;F;151;1393643546;1411953261;18309715;302.739.996.693.122
KangZayd/customColorPicker;com.flask.colorpicker.sample;G;151;1426924122;1474423241;47499119;785.369.031.084.656
devnatres/DashProject;devnatres.android.boomarung;G;152;1420205024;1442657424;22452400;371.236.772.486.772
jeremyleee/Duckie;com.tragicfruit.duckie;G;152;1422711783;1453191845;30480062;503.969.279.100.529
TTTDevs/Diaspora-Native-WebApp;ar.com.tristeslostrestigres.diasporanativewebapp;G;152;1434162078;1489665341;55503263;917.712.681.878.307
dragthor/learning;com.kriskrause.learning;G;152;1388316016;1489183102;100867086;166.777.589.285.714
jamessanford/kegs;com.froop.app.kegs;G;153;1344296055;1399425655;55129600;911.534.391.534.392
laitkor/bookdash;org.bookdash.android;G;154;1448473872;1462178617;13704745;226.599.619.708.995
sangcomz/Open_SNS;xyz.sangcomz.open_sns;G;154;1450338101;1485445208;35107107;580.474.652.777.778
loadrunner/Facebook-Contact-Sync;ro.weednet.contactssync;F;154;1345021109;1444055413;99034304;163.747.195.767.196
Iljalala/HansaVK;com.ilja.vk_hansa;G;155;1452102418;1473715089;21612671;357.352.364.417.989
scruffyfox/AndroidCourse;com.cube.arc.pfa;G;156;1391690707;1398532477;6841770;113.124.503.968.254
guillaume-roy/winenjoy.app;com.winenjoy.app;G;156;1455869683;1477483380;21613697;357.369.328.703.704
Nilhcem/frcndict-android;com.nilhcem.frcndict;F;156;1324810870;1359904537;35093667;580.252.430.555.556
dirktrossen/AIRS;com.airs;F;156;1311767896;1420634200;108866304;18.000.380.952.381
RSenApps/Commandr-Android;com.RSen.Commandr;G;157;1406267456;1433916080;27648624;457.153.174.603.175
The1andONLYdave/fireinstaller;com.dlka.fireinstaller;G;157;1416259469;1450209290;33949821;561.339.632.936.508
artiomchi/Dual-Battery-Widget;org.flexlabs.widgets.dualbattery;G;157;1308039141;1344767780;36728639;607.285.697.751.323
rorist/Cowsay-android;ch.fixme.cowsay;F;157;1324931877;1436180578;111248701;183.942.958.002.645
ikuo/garaponoid;com.github.ikuo.garaponoid;G;159;1399184459;1427556610;28372151;469.116.253.306.878
ThatKawaiiGuy/Handbook_for_Melee;com.thatkawaiiguy.meleehandbook&amp;G;159;1446956230;1493164138;46207908;764.019.642.857.143
miraiProjectB/WakeUp;com.jawbone.upopen&amp;G;160;1446478845;1454055725;7576880;125.279.100.529.101
Sushinski/nomprenom;com.nomprenom2;G;160;1455886047;1491637686;35751639;591.131.597.222.222
droid-in-the-sky/rocks;org.droid_in_the_sky.rocks;G;160;1380385998;1456339216;75953218;125.584.024.470.899
rastating/DroidBeard;com.rastating.droidbeard;G;160;1407625107;1487881259;80256152;132.698.664.021.164
piyurabadiya/MultiImagePicker;net.yazeed44.imagepicker.sample;G;161;1417081784;1453632444;36550660;604.342.923.280.423
torrenegras/R07D;com.xoaquin.r07d;G;161;1383433372;1451886942;68453570;113.183.812.830.688
JoseExposito/ubuntuone-qt-files;org.qtproject.example.U1Files;F;161;1383603188;1453895323;70292135;116.223.768.187.831
mthli/Bitocle;io.github.mthli.Bitocle;G;162;1399135765;1423190731;24054966;397.734.226.190.476
archpoint/FuelPlanner;com.connectutb.xfuel;G;162;1358780501;1464700230;105919729;175.131.827.050.265
derekcsm/hubble_gallery;com.derek_s.hubble_gallery;F;163;1432453760;1482959115;50505355;835.075.314.153.439
xebia-france/devoxx-mobile;fr.xebia.devoxx;G;165;1329263751;1427836859;98573108;162.984.636.243.386
martymarkenson/PeriodicTable;com.eduvrse.ProductName&amp;G;166;1461372641;1475358847;13986206;231.253.406.084.656
gwhiteside/abstract-art;net.georgewhiteside.android.abstractart;F;166;1330049711;1344527846;14478135;239.387.152.777.778
knilch0r/freeshisen;org.proofofconcept.shisensho;G;167;1361734821;1492438781;130703960;216.111.044.973.545
zetbaitsu/CodePolitan;id.zelory.codepolitan;G;168;1438087655;1445071444;6983789;115.472.701.719.577
LeePresswood/PathPuzzle;com.pressedlee.breaktheice&amp;G;168;1418947069;1451541538;32594469;538.929.712.301.587
Sid25081998/VDiary;com.fourthstatelabs.zchedule;G;169;1480601082;1492619264;12018182;198.713.326.719.577
orrc/fosdem-android;org.fosdem;G;169;1263240657;1370354657;107114000;177.106.481.481.481
webpay/webpay-token-android;jp.webpay.android.token.sample;G;171;1394162530;1434602601;40440071;668.651.967.592.593
jarvislin/Produce-Price-Checker;com.jarvislin.producepricechecker;G;171;1413264764;1454039255;40774491;674.181.398.809.524
stefanhaustein/flowgrid;org.flowgrid;G;171;1451742081;1493077956;41335875;683.463.541.666.667
skullone/android_firewall;com.jtschohl.androidfirewall;F;171;1351473435;1406128812;54655377;903.693.402.777.778
aminb/mathtools;org.aminb.mathtools.app;F;172;1400285328;1415680554;15395226;254.550.694.444.444
Kaljurand/Arvutaja;ee.ioc.phon.android.arvutaja;G;173;1317206061;1488496193;171290132;283.217.810.846.561
numixproject/org.numixproject.hermes;org.numixproject.hermes;G;174;1421247497;1439371497;18124000;299.669.312.169.312
romero4742/AndroidCrazyFlieTwitch;se.bitcraze.crazyfliecontrol2;G;175;1352044501;1433584283;81539782;134.821.068.121.693
paucasas/pagoda;parts.code.pagoda;G;176;1486855874;1492465264;5609390;927.478.505.291.005
mikljohansson/retroboy;se.embargo.retroboy;G;176;1334397706;1438197519;103799813;171.626.674.933.862
chatrealm/DctvAndroid;com.tinnvec.dctvandroid;G;177;1448642298;1482866268;34223970;56.587.251.984.127
mobiletech2100/CropImage;com.yalantis.ucrop.sample&amp;G;177;1453365463;1491227389;37861926;626.023.908.730.159
TrevorEdwards/bigredapp-android;is.genki.bigredapp.android&amp;G;177;1426962421;1492393926;65431505;10.818.701.223.545
thiemonagel/vegdroid;de.thiemonagel.vegdroid;G;178;1352460649;1366104563;13643914;225.593.816.137.566
DanielCoutts/Dyne;com.team18.teamproject;G;178;1445953762;1469749766;23796004;393.452.447.089.947
Konstantin8105/NLP-modeling;com.modelingbrain.home&amp;G;180;1469559158;1483094850;13535692;223.804.431.216.931
songshimvp/premotedroid;org.pierre.remotedroid.client&amp;G;180;1266750687;1448439353;181688666;300.411.154.100.529
geekosphere-net/sgpAndroid;info.staticfree.SuperGenPass&quot;G;181;1238351404;1451720346;213368942;352.792.562.830.688
LukeStonehm/LogicalDefence;za.co.lukestonehm.logicaldefence;F;182;1421512778;1493817883;72305105;119.552.091.600.529
scottmangiapane/calculator-v2;com.scottmangiapane.calculatorv2;G;184;1450585173;1481402351;30817178;509.543.287.037.037
ac-pm/Inspeckage;mobi.acpm.inspeckage;G;184;1456700634;1488453906;31753272;525.021.031.746.032
52North/sosmobileclient;org.n52.sosmobileclient;G;186;1371645454;1384615252;12969798;214.447.718.253.968
frankkienl/Convention;nl.frankkie.convention;G;186;1416148756;1433745331;17596575;290.948.660.714.286
karhatsu/Suosikkipysakit;com.karhatsu.suosikkipysakit;G;186;1351015767;1406188735;55172968;912.251.455.026.455
kpii/my2cents-android;mobi.my2cents;G;187;1342107054;1354823609;12716555;210.260.499.338.624
mrksbrg/RacketGhost;com.markusborg.test&amp;G;187;1383669805;1484820985;101151180;167.247.321.428.571
apotapov/tafl;com.captstudios.games.tafl;G;188;1390083440;1440729917;50646477;837.408.680.555.556
BenoitDuffez/AndroidCupsPrint;io.github.benoitduffez.cupsprint;G;188;1433493268;1492728931;59235663;97.942.564.484.127
edrews/BrewShopApp;com.brew.brewshop;F;188;1409010557;1492218048;83207491;137.578.523.478.836
dpadgett/Timer;org.dpadgett.timer;F;189;1326161885;1392880154;66718269;110.314.598.214.286
dbacinski/meteopl-unofficial;pl.dariuszbacinski.meteo;G;190;1442950068;1453130532;10180464;168.327.777.777.778
matejdro/PebbleDialer-Android;com.matejdro.pebbledialer;G;190;1381860934;1488981153;107120219;177.116.764.219.577
arnaudbreton/reste-assis-tes-prevenu;com.resteassistesprevenu;G;191;1343487442;1353951220;10463778;173.012.202.380.952
EEdge/FoodCraft;sfsu.csc413.foodcraft;G;192;1443828884;1454542235;10713351;177.138.740.079.365
chillcoding-at-the-beach/bachamada;fr.machada.bpm;G;192;1438240102;1467207403;28967301;478.956.696.428.571
thetwoj/Meadows;com.osu.sc.meadows;G;192;1318798107;1486147849;167349742;276.702.615.740.741
sregg/spotify-tv;com.spotify.tv.android;G;193;1428792414;1487616875;58824461;972.626.669.973.545
dperetin/LinuxZaSve_mobile;com.linuxzasve.mobile;G;194;1342043237;1416948433;74905196;123.851.183.862.434
EmmanuelMess/Simple-Accounting;com.emmanuelmess.simpleaccounting;G;195;1459444042;1493659800;34215758;565.736.739.417.989
GreenLionSoft/madrid-pollution-android-app;com.greenlionsoft.pollution.madrid;G;195;1445762411;1493287242;47524831;785.794.163.359.788
appteam-nith/festnimbus;com.appteam.nimbus&amp;G;196;1454694131;1479996852;25302721;418.365.095.899.471
SimonMarquis/Android-PreferencesManager;fr.simon.marquis.preferencesmanager;F;196;1369004608;1462991121;93986513;155.400.980.489.418
ymback/NGA-CLIENT-VER-OPEN-SOURCE;gov.anzong.androidnga;G;196;1388861084;1492740577;103879493;171.758.420.965.608
gmurph52/BossWorkClock;theWorkClock2.BossWorkClock2.gerald.thebossworkclock&amp;G;197;1433354492;1455254106;21899614;362.096.792.328.042
doerfli/hacked;li.doerf.hacked;G;198;1473115186;1490562091;17446905;288.473.958.333.333
wststreet2/LcdLiveWallpaper;org.kamehamehaaa.android.livewallpaper;G;198;1361468416;1400865318;39396902;651.403.802.910.053
williamwu2049/Multi-Cal;com.williamwu2049.calculator;G;200;1485912870;1493146881;7234011;119.609.970.238.095
mvestola/helsinki-testbed2-android;fi.testbed2;G;200;1347784633;1479488935;131704302;217.765.049.603.175
salminnella/PreScoop;com.project.salminnella.prescoop;G;201;1462222110;1467399486;5177376;856.047.619.047.619
hallower/wimple;com.blogspot.charlie0301;G;201;1428154547;1490716371;62561824;103.442.169.312.169
grchld/rftg-scorer;org.rftg.scorer;G;202;1363684347;1389404713;25720366;425.270.601.851.852
joan-domingo/FitnessTracker;cat.xojan.fittracker;G;202;1418471330;1474664795;56193465;929.124.751.984.127
bpeel/prevo;uk.co.busydoingnothing.prevo;G;202;1340395602;1491512543;151116941;249.862.666.997.354
tylervernonsmith/ChronoChat-android;net.named_data.android.chronochat;G;203;1487296215;1492218814;4922599;813.921.792.328.042
giginet/KawazCrash;org.kawaz.KawazCrash;G;204;1403184919;1417060622;13875703;229.426.306.216.931
NahroTo/Fruit-Destroyer;com.nahroto.fruitdestroyer.android;G;204;1442244626;1476700142;34455516;569.700.992.063.492
Evin1-/Polls;com.loopcupcakes.apps.polls;G;205;1453833288;1470451188;16617900;274.766.865.079.365
boxhead201/HKORadar;com.boxhead.android.hkoradar;G;205;1441636659;1493909371;52272712;864.297.486.772.487
JesseScott/SecondStory-Android;com.theonlyanimal.secondstory;G;206;1393460122;1454827754;61367632;101.467.645.502.645
emilburzo/nexus7sms;com.emilburzo.nexus7sms;G;206;1417533314;1486491618;68958304;11.401.835.978.836
walles/headsetharry;com.gmail.walles.johan.headsetharry;G;207;1460572045;1484890897;24318852;402.097.420.634.921
Rox87/editor1;com.onegravity.rteditor.demo;G;207;1433214179;1488386920;55172741;912.247.701.719.577
s0nicyouth/acalc;com.syouth.acalc;G;208;1440175705;1493474400;53298695;881.261.491.402.116
yuanyu0714/XAlarm;com.yuanyu.xalarm;G;209;1394059202;1406900920;12841718;212.329.993.386.243
iClaude/PersonalBudget;com.flingsoftware.personalbudget&amp;G;209;1453999829;1493744816;39744987;657.159.176.587.302
OpenArchive/openarchive;net.opendasharchive.openarchive.release;F;209;1418417404;1492025204;73607800;121.706.018.518.519
jpeddicord/speedofsound;net.codechunk.speedofsound;F;209;1335275726;1478477524;143201798;236.775.459.656.085
JeanAnouilh/SwarmPulse;ch.ethz.coss.nervous.pulse;G;210;1442416696;1479100254;36683558;606.540.310.846.561
AlexGilleran/HIITMe;com.alexgilleran.hiitme;G;211;1360553322;1424511620;63958298;105.751.154.100.529
marshallino16/WhichMovie-Android;genyus.com.whichmovie;G;212;1448492639;1459708091;11215452;185.440.674.603.175
jpapayan/tuberun_android;com.papagiannis.tuberun;G;213;1319313890;1379367403;60053513;992.948.296.957.672
richsmith/sexytopo;org.hwyl.sexytopo;G;213;1417130849;1489363729;72232880;119.432.671.957.672
wisedog/Whoochoo;net.wisedog.android.whooing;G;213;1333980154;1409111375;75131221;12.422.490.244.709
emerssso/SRBase;com.gmail.emerssso.srbase;G;213;1389714200;1476399166;86684966;143.328.316.798.942
FieldDB/AndroidSpeechRecognitionTrainer;com.github.opensourcefieldlinguistics.fielddb.speech.kartuli;G;213;1347388681;1440990929;93602248;154.765.621.693.122
shlusiak/FruPic-App;de.saschahlusiak.frupic;G;213;1330031143;1440941350;110910207;183.383.278.769.841
nshiba/NarouTime;net.nashihara.naroureader;G;215;1460947969;1490530779;29582810;489.133.763.227.513
orome656/HOFCAndroid;com.hofc.hofc;G;215;1396902869;1456316793;59413924;982.373.082.010.582
zostay/CPAN-Sidekick;com.qubling.sidekick;G;216;1322719250;1365344455;42625205;704.781.828.703.704
atkonn/iwashi3d;jp.co.qsdn.android.jinbei3d;F;217;1309195110;1337912683;28717573;474.827.595.899.471
Tortel/SysLog;com.tortel.syslog;F;217;1351694589;1487791638;136097049;225.028.189.484.127
phil-lopreiato/frc-notebook;com.plnyyanks.frcnotebook;G;218;1393094719;1489516370;96421651;159.427.333.002.645
midhunhk/message-counter;com.ae.apps.messagecounter;G;218;1367552039;1480524541;112972502;186.793.158.068.783
bogdanguranda/sokobug;sokobug.android;G;220;1423779644;1435002852;11223208;185.568.915.343.915
micdm/transport-live;com.micdm.transportlive;G;220;1392173049;1426604648;34431599;569.305.539.021.164
navidmatin/BuckeyeBuilder;com.infinityloop.buckeyebuilder&amp;G;221;1391532513;1446618308;55085795;910.810.102.513.228
yuukis/businessmap;com.github.yuukis.businessmap;G;222;1375894529;1404319589;28425060;469.991.071.428.571
BijdorpStudio/UrlSetter;com.teaandtoys.unshorten;G;223;1379145919;1433835839;54689920;90.426.455.026.455
Brlgomez/Block-Walk;com.brandongomez.voxvoyager;G;224;1485197346;1493146793;7949447;131.439.269.179.894
ekke/c2gQtCon_x;org.ekkescorner.c2g.qtcon;G;225;1468963575;1493134689;24171114;399.654.662.698.413
omegahm/DBP2P;dk.hotmovinglobster.battleships;F;225;1297718041;1348690174;50972133;842.793.204.365.079
YuyaItoh/Piyo_PuzzleGame;org.digda.kuisap&amp;G;226;1382166979;1419672905;37505926;620.137.665.343.915
pcalabrese/Mobike-MOBAPP;com.mobiketeam.mobike&amp;G;226;1419076056;1481462018;62385962;103.151.392.195.767
jecelyin/920-text-editor-v2;com.jecelyin.editor.v2;G;228;1461052101;1486967648;25915547;428.497.800.925.926
hoolrory/VideoInfoViewer;com.roryhool.videoinfoviewer;G;228;1392500127;1477007365;84507238;139.727.576.058.201
direvus/third;au.id.swords.third2;G;230;1153209473;1488001510;334792037;55.355.826.223.545
emmaguy/wear-notify-for-reddit;com.emmaguy.todayilearned;G;231;1406457409;1465639291;59181882;978.536.408.730.159
Bandits789/WhatSongIsItAnyway;com.wsiia;G;232;1393437224;1404170406;10733182;177.466.633.597.884
torjusbr/Cardify;fr.eurecom.cardify;G;232;1381930538;1397164229;15233691;251.879.811.507.937
gdmalet/grtransit;net.kw.shrdlu.grtgtfs;F;232;1306210657;1474913640;168702983;27.894.011.739.418
OvidiuCaba/StatisticsRomania;com.statisticiromania.app;G;233;1455949304;1493831814;37882510;626.364.252.645.503
SoftTech2018/Convoy;gruppe3.convoy;G;234;1447659841;1463121842;15462001;255.654.778.439.153
ZorgeR/datFM;com.zlab.datFM;F;234;1360098215;1469043257;108945042;180.133.998.015.873
KChernenko/WhatToWatch;me.bitfrom.whattowatch;G;235;1443823468;1481378572;37555104;620.950.793.650.794
ryanpconnors/art-thief;com.ryanpconnors.artthief;G;237;1454971640;1487448670;32477030;53.698.792.989.418
goodkode/SimpleRunTracker;net.takoli.simpleruntracker;G;237;1395596997;1465237052;69640055;115.145.593.584.656
galvanom/BestAlarm;com.alarm.androidalarm;G;238;1476117194;1491067509;14950315;247.194.361.772.487
mikepenz/wallsplash-android;com.mikepenz.unsplash;F;238;1421609731;1493655005;72045274;119.122.476.851.852
swentel/gentsefeesten;com.genschefieste;G;238;1370371986;1488921413;118549427;196.014.264.219.577
rmceoin/cominghome;net.mceoin.cominghome;G;239;1408581763;1450053094;41471331;685.703.224.206.349
jfsaaved/adventures-of-kobe;com.mygdx.runrunrun.android;G;240;1437798246;1449446282;11648036;192.593.187.830.688
aaronistheman/Android-Spacecraft-Game;enterprises.wayne.spacecraftgame&amp;G;242;1451190561;1470809647;19619086;324.389.649.470.899
Anasthase/TintBrowser;org.tint;F;242;1329242531;1432918425;103675894;171.421.782.407.407
Doelia/emp-parser;fr.doelia.calendrierfds;G;244;1445327443;1453312024;7984581;132.020.188.492.063
makoto0610/Mobster;com.the_great_amoeba.mobster;G;245;1475516866;1493263680;17746814;293.432.771.164.021
huy-lv/lens-launcher;nickrout.lenslauncher;G;245;1459467078;1490958848;31491770;520.697.255.291.005
garrapeta/jumplings;com.garrapeta.jumplings;G;246;1344119609;1418814629;74695020;123.503.670.634.921
TheKeeperOfPie/Reader;com.winsonchiu.reader;G;247;1424124392;1472337182;48212790;797.169.146.825.397
ciasaboark/Tacere;org.ciasaboark.tacere.key;F;247;1371929801;1451059683;79129882;13.083.644.510.582
devsunset/rockfish;kh.devsunset.rockfish&amp;G;250;1463058567;1479476138;16417571;271.454.546.957.672
henrytao-me/smooth-app-bar-layout;me.henrytao.smoothappbarlayout;G;250;1443342323;1487021858;43679535;722.214.533.730.159
btcontract/wallet;com.btcontract.wallet;G;251;1436980961;1491124947;54143986;895.237.863.756.614
appteam-nith/Nimbus;com.appteam.nith.nimbus;G;252;1486388676;1491854389;5465713;903.722.387.566.138
crysxd/Anybeam;de.hfu.anybeam.android;G;254;1384158395;1448103878;63945483;105.729.965.277.778
Neamar/CineTime;fr.neamar.cinetime;G;256;1357592313;1438701898;81109585;134.109.763.558.201
superjeffreyc/Yut;com.jeffreychan.yunnori;G;257;1455375018;1489953106;34578088;571.727.645.502.646
nethergrim/GymDiary;com.nethergrim.combogymdiary;G;259;1384246350;1404128057;19881707;328.731.927.910.053
alopatindev/smsnenado;com.sbar.smsnenado;G;261;1375966665;1438910588;62943923;104.073.946.759.259
MyHappyHog/ProjectPrototype;kookmin.cs.happyhog;G;262;1441108185;1464838943;23730758;392.373.644.179.894
Mikuz/Boarder;fi.mikuz.boarder;G;262;1336077002;1402951783;66874781;110.573.381.283.069
appteam-nith/Hillffair;appteam.nith.hillffair;G;265;1472297501;1491854217;19556716;323.358.399.470.899
mohaxspb/ScpFoundationRu;ru.dante.scpfoundation;G;266;1465319932;1493840786;28520854;471.574.966.931.217
koelleChristian/trickytripper;de.koelle.christian.trickytripper;G;266;1326749218;1479931365;153182147;253.277.359.457.672
sweetiepiggy/Report-Malaysia-Taxi;com.sweetiepiggy.reportmalaysiataxi;G;267;1328685759;1375710006;47024247;777.517.311.507.936
smithdtyler/prettygoodmusicplayer;com.smithdtyler.prettygoodmusicplayer;G;268;1407640253;1491274757;83634504;138.284.563.492.063
ryanamaral/android-quill;com.write.Quill;G;268;1325642090;1428873105;103231015;170.686.202.050.265
ebeanstalkuf/Beanstalk;com.nimbus.app.beanstalk;G;269;1348945022;1357854860;8909838;14.731.875
xisberto/workschedule;net.xisberto.work_schedule;G;269;1353768263;1404351298;50583035;836.359.705.687.831
gtzinos/Crowd-Gaming-Android;tzinos.crowdgaming;G;270;1466917175;1475871281;8954106;148.050.694.444.444
AICP/packages_apps_KernelAdiutor;com.grarak.kerneladiutor;G;271;1419633415;1427636076;8002661;132.319.130.291.005
seokgun88/CDP-09;com.origin.seok.knuplan;G;273;1459680225;1477205368;17525143;289.767.576.058.201
digitalica/skydivekompasroos;nl.digitalica.skydivekompasroos;G;273;1352766891;1439968460;87201569;144.182.488.425.926
espiegel/meeba;com.meeba.google&amp;G;277;1383766241;1428566228;44799987;740.740.525.793.651
m45t3r/retrobreaker;br.usp.ime.retrobreaker;F;277;1398690254;1461777015;63086761;104.310.120.701.058
castaway2000/PawpadsAndroid;saberapplications.pawpads;G;279;1482477251;1492196259;9719008;160.697.883.597.884
alberapps/tiempobus;alberapps.android.tiempobus;G;279;1365179635;1489859271;124679636;206.150.191.798.942
na4lapy/na4lapy-android;pl.kodujdlapolski.na4lapy;G;280;1456347654;1492728329;36380675;60.153.232.473.545
crysxd/Studiportal-Checker;de.hfu.funfpunktnull;G;283;1405589619;1474294982;68705363;11.360.013.723.545
Venryx/LucidLink;v.lucidlink;G;284;1479306256;1489672038;10365782;171.391.898.148.148
j-jorge/asgp;com.RhemaGroup.AndyAdventure;F;284;1359150277;1406580050;47429773;784.222.437.169.312
iljaosintsev/Ursmu;ru.ursmu.application;G;285;1380015632;1485251561;105235929;174.001.205.357.143
jamtartley/Noted;com.cerebellio.noted;G;286;1454988381;1460565613;5577232;922.161.375.661.376
Mikuz/Ghost-Realm;fi.ghostrealm;G;286;1379073234;1402429129;23355895;386.175.512.566.138
asksven/BetterWifiOnOff;com.asksven.betterwifionoff;F;286;1342269358;1419681675;77412317;127.996.555.886.243
kevxiao/Wumbo;com.star.patrick.wumbo;G;287;1476543888;1483247744;6703856;11.084.417.989.418
jajimenez/workpage;jajimenez.workpage;G;287;1414348555;1477582027;63233472;104.552.698.412.698
SharkMolace/jkl;com.telerik.examples&amp;G;288;1391182280;1484750197;93567917;154.708.857.473.545
rubengees/Vocabletrainer;com.rubengees.vocables;G;289;1429911785;1448837911;18926126;312.931.977.513.228
stanidesis/quotograph;com.stanleyidesis.quotograph&amp;G;289;1436151453;1477440922;41289469;682.696.246.693.122
mwesner/GBHS-Android;com.grandblanchs.gbhs;G;290;1412894185;1482347551;69453366;11.483.691.468.254
Mortech/HexGame_Android2;com.sam.hex;G;291;1318441924;1336958799;18516875;306.165.261.243.386
walles/batterylogger;com.gmail.walles.johan.batterylogger;G;291;1404243615;1474475064;70231449;116.123.427.579.365
mgrcar/EmotivSdk;com.emotiv.insightapp;G;293;1444021947;1490949067;46927120;775.911.375.661.376
cesar1287/BrasilCardFacil-android-app;br.com.brasilcardfacil.www.brasilcardfacil;G;295;1480544019;1492868867;12324848;203.783.862.433.862
free5ty1e/primestationone-control-android;com.chrisprime.primestationonecontrol;G;296;1436923205;1480095517;43172312;71.382.791.005.291
dbdkmezz/true-sight-dota;com.carver.paul.truesight;G;298;1445756044;1491894967;46138923;762.879.017.857.143
DrKLO/Telegram;org.telegram.messenger;W;300;1382714340;1490918285;108203945;178.908.639.219.577
Kaljurand/K6nele;ee.ioc.phon.android.speak;F;300;1324473214;1493850566;169377352;280.055.145.502.646
javiersantos/MLManager;com.javiersantos.mlmanager;F;302;1432207817;1468058617;35850800;592.771.164.021.164
sweetiepiggy/Raspberry-Bus-Malaysia;com.sweetiepiggy.raspberrybusmalaysia;G;302;1332933042;1373042564;40109522;663.186.541.005.291
dkunzler/masterpassword;de.devland.masterpassword;F;302;1408830183;1485113160;76282977;126.129.260.912.698
nloko/SyncMyPix;com.nloko.android.syncmypix;F;303;1251533516;1350720837;99187321;164.000.200.066.138
johanjusits/LastStraw;johan.laststraw;G;304;1415728547;1425746313;10017766;165.637.665.343.915
lvonasek/Open4speed;com.lvonasek.o4s;G;304;1390404859;1477062809;86657950;143.283.647.486.772
BilingualAphasia/AndroidBilingualAphasiaTest;ca.ilanguage.bilingualaphasiatest;G;309;1301151539;1354550094;53398555;882.912.615.740.741
redPanda-project/android;org.redPanda;G;313;1373552838;1458687830;85134992;140.765.529.100.529
SpiritCroc/AKG-Vertretungsplan;de.spiritcroc.akg_vertretungsplan;G;314;1434047959;1467801257;33753298;558.090.244.708.995
littledot/Permission-Nanny;com.permissionnanny;F;315;1429867688;1484018960;54151272;895.358.333.333.333
FranckRJ/RespawnIRC-Android;com.franckrj.respawnirc;G;318;1476985375;1493742716;16757341;277.072.437.169.312
MihaiBalint/TimisoaraPublicTransport;ro.mihai.tpt&amp;G;318;1302855992;1471566815;168710823;278.953.080.357.143
edipo2s/TESLegendsTracker;com.ediposouza.teslesgendstracker;G;322;1477780614;1492481576;14700962;243.071.461.640.212
seemoo-lab/nexmon;de.tu_darmstadt.seemoo.nexmon;G;323;1477555587;1493716202;16160615;267.205.935.846.561
DSteve595/Put.io;com.stevenschoen.putionew;G;323;1347238579;1493593595;146355016;241.989.113.756.614
MobileDevelopersOfBerkeley/WingIt;com.mdb.wingit.wingit&amp;G;324;1478385979;1493008929;14622950;241.781.580.687.831
metinkale38/prayer-times-android;com.metinkale.prayer;G;325;1451564347;1493883769;42319422;699.725.892.857.143
prasad79/nervousnet-android;ch.ethz.coss.nervousnet.hub;G;326;1449680288;1476787186;27106898;448.196.064.814.815
80171703/myGitHubLibrary;paolorotolo.github.com.appintroexample&amp;G;329;1433347330;1468235533;34888203;576.855.208.333.333
bpeel/catverbs;uk.co.busydoingnothing.catverbs;F;332;1396298590;1440842307;44543717;736.503.257.275.132
bompo/mgcube;de.redlion.qb;F;332;1307984849;1387105924;79121075;130.821.883.267.196
argilo/BusFollower;net.argilo.busfollower;G;332;1332506078;1491308574;158802496;262.570.264.550.265
TripleLoopGames/space-roaches;com.tripleloopgames.spaceroaches;G;339;1444676716;1462881464;18204748;301.004.431.216.931
doniyorprince95/android-chess;jwtc.android.chess;G;340;1396093128;1474211046;78117918;129.163.224.206.349
zielmicha/freeciv-android;pl.org.zielinscy.freeciv;F;340;1314532361;1399738854;85206493;140.883.751.653.439
peppe130/ROMInstaller;com.peppe130.rominstaller;G;342;1466628249;1482308573;15680324;259.264.616.402.116
niranjan94/show-java;com.njlabs.showjava;F;350;1387900610;1487907576;100006966;165.355.433.201.058
damien5314/Flippit;com.ddiehl.android.reversi;G;352;1412814394;1491406431;78592037;129.947.151.124.339
rdeguzman/itrackmygps-android;com.twormobile.itrackmygps;G;354;1379994330;1466243474;86249144;142.607.711.640.212
micwallace/reddinator;au.com.wallaceit.reddinator;F;354;1363338108;1484987836;121649728;201.140.423.280.423
75py/Aplin;com.nagopy.android.aplin;G;356;1444396177;1488705491;44309314;732.627.546.296.296
mobnetic/BitcoinChecker;com.mobnetic.coinguardian;G;359;1393445492;1493386903;99941411;165.247.041.997.355
futurice/meeting-room-tablet;com.futurice.android.reservator;F;361;1291374118;1476184015;184809897;305.571.919.642.857
Sekwel/Swiftp_source;be.ppareit.swiftp;G;362;1236470282;1461787678;225317396;372.548.604.497.355
AaronDP/vimtouch_adbshell;net.momodalo.app.vimtouch;G;363;1347340940;1420165073;72824133;12.041.027.281.746
mohaxspb/Odnako;ru.kuchanov.odnako;G;364;1412766810;1443263677;30496867;504.247.139.550.265
lordi/tickmate;de.smasi.tickmate;F;366;1389541982;1493464616;103922634;171.829.751.984.127
nextgis/metro4all-android;com.nextgis.metroaccess;G;367;1425318613;1458567158;33248545;549.744.460.978.836
kt3kstudio/whatsmyip-android;com.kt3k.app.whatsmyip;G;370;1371730595;1416790922;45060327;745.045.089.285.714
ymmah/mycelium-wallet;com.mycelium.wallet;G;370;1371117161;1482231080;111113919;183.720.104.166.667
buddycloud/buddycloud-android;com.buddycloud;F;383;1359985666;1426005714;66020048;109.160.132.275.132
Shubhamgoel123/QuizApp-Android;com.quizapp.tollywood;G;384;1407993189;1459191864;51198675;846.538.938.492.064
pflammertsma/cryptogram;com.pixplicity.cryptogram;F;385;1477663924;1493208967;15545043;257.027.827.380.952
Helius/narmon-client;com.ghelius.narodmon&amp;G;385;1355901337;1427780787;71879450;118.848.296.957.672
ksedgwic/Wallet32;com.bonsai.wallet32;G;389;1380583546;1413909042;33325496;551.016.798.941.799
MojRoid/TIIK;com.tiikit.tiik;G;391;1426607537;1465833952;39226415;648.584.904.100.529
HyphenateInc/Hyphenate-Demo-Android;com.hyphenate.chatuidemo&amp;G;398;1466549211;1493102567;26553356;439.043.584.656.085
stkent/bugshaker-android;com.github.stkent.bugshaker;G;400;1452263529;1493808482;41544953;686.920.519.179.894
sheimi/SGit;me.sheimi.sgit;F;401;1376670602;1478212828;101542226;167.893.892.195.767
RCasatta/EternityWallAndroid;it.eternitywall.eternitywall;G;403;1441199116;1476430571;35231455;582.530.671.296.296
kkawai/instachat;com.instachat.android;G;404;1466509400;1490195874;23686474;391.641.435.185.185
asafge/NewsBlurPlus;com.asafge.newsblurplus;G;404;1373011469;1419142764;46131295;762.752.893.518.519
JNVgames/Betrayal;com.jnv.Betrayal.android&amp;G;408;1437085706;1483638199;46552493;769.717.146.164.021
sagemath/android;org.sagemath.droid;W;411;1371590959;1416120199;44529240;736.263.888.888.889
matyo91/ChinesePuzzle;com.darkwood.chinesepuzzle;G;415;1323183000;1447515016;124332016;205.575.423.280.423
bkueng/clash_of_balls;com.sapos_aplastados.game.clash_of_balls;G;421;1352998987;1367047967;14048980;232.291.335.978.836
oss-fruct-org/audioguide;org.fruct.oss.audioguide;G;421;1392798150;1428833016;36034866;595.814.583.333.333
eziosoft/MultiWii_EZ_GUI;com.ezio.multiwii;G;425;1349300419;1390955884;41655465;688.747.767.857.143
cstroe/maniana;com.zapta.apps.maniana;G;426;1328338052;1371047979;42709927;70.618.265.542.328
aokp/external_jbirdvegas_mGerrit;com.jbirdvegas.mgerrit;F;432;1364766556;1373925687;9159131;151.440.658.068.783
benoitletondor/EasyBudget;com.benoitletondor.easybudgetapp;G;438;1419506038;1467379942;47873904;791.565.873.015.873
aminb/cabinet;com.afollestad.cabinet;G;443;1406489664;1412736920;6247256;103.294.576.719.577
nao20010128nao/PhpApp;com.esminis.server.php;G;447;1369854795;1465110447;95255652;157.499.424.603.175
SecrecySupportTeam/secrecy;com.doplgangr.secrecy;G;457;1397896117;1488962161;91066044;150.572.162.698.413
farmerbb/Taskbar;com.farmerbb.taskbar;G;461;1470356688;1493848296;23491608;388.419.444.444.444
varunn12/Reweyou;in.reweyou.reweyou;G;464;1475651588;1484148220;8496632;14.048.664.021.164
smarek/Simple-Dilbert;com.mareksebera.dilbert;F;467;1364246554;1482490997;118244443;195.509.991.732.804
adq/redbus;org.redbus;G;478;1273606194;1489322250;215716056;356.673.373.015.873
shadmin/sporthenon;com.sporthenon.android;G;482;1381332599;1491571852;110239253;182.273.897.156.085
RomanGolovanov/ametro;org.ametro;G;482;1261840432;1457814404;195973972;324.031.038.359.788
atomjack/VoiceControlForPlex;com.atomjack.vcfp;G;485;1387764556;1484243842;96479286;159.522.628.968.254
indywidualny/FaceSlim;org.indywidualni.faceslim_donation;G;497;1420627894;1491041138;70413244;116.424.014.550.265
xplodwild/android_packages_apps_Focal;fr.xplod.focal.donate;F;499;1369329101;1392980869;23651768;391.067.592.592.593
kiall/android-tvheadend;ie.macinnes.tvheadend;G;499;1465493659;1493576594;28082935;464.334.242.724.868
chaosbastler/opentraining;de.skubware.training_app;F;503;1345455343;1457879512;112424169;18.588.652.281.746
coinblesk/coinblesk-client-gui;com.coinblesk.client;G;506;1453197822;1493834299;40636477;671.899.421.296.296
alxhill/BrainSlice;com.lemonslice.brainslice;G;508;1386585430;1414510663;27925233;461.726.736.111.111
FieldDB/AndroidFieldDB;com.github.opensourcefieldlinguistics.fielddb.lessons.georgian;G;508;1395917596;1442156013;46238417;764.524.090.608.466
QSCTech/QSCMobileLegacy;com.myqsc.mobile2;G;511;1375760736;1433153555;57392819;948.955.340.608.466
ikarus23/MifareClassicTool;de.syss.MifareClassicTool;F;516;1360683544;1492952888;132269344;218.699.312.169.312
nolanlawson/KeepScore;com.nolanlawson.keepscore;F;520;1307751661;1463319993;155568332;257.222.771.164.021
moscrop-secondary-school/moscrop-secondary-app;com.moscrop.official;G;522;1403503658;1444114062;40610404;67.146.832.010.582
TeMoMuKo/AutoStopRace-Android;pl.temomuko.autostoprace;G;522;1452044103;1493375660;41331557;683.392.146.164.021
warmshowers/wsandroid;fi.bitrite.android.ws;G;526;1327267389;1445985603;118718214;196.293.343.253.968
username115/FRCScouting;org.growingstems.scouting;G;531;1386527121;1493393758;106866637;176.697.481.812.169
IBobko/TrainingForCamel;de.skubware.opentraining;G;541;1345455343;1479800008;134344665;222.130.729.166.667
TapTapTapps/WayPath;com.TapTapTapps.WayPath;G;549;1438640584;1473302852;34662268;573.119.510.582.011
T-Rex96/Easy_xkcd;de.tap.easy_xkcd;F;556;1437648803;1492971643;55322840;914.729.497.354.497
SaurabhNetra/cricdecode;co.acjs.cricdecode&amp;G;556;1372176180;1443195294;71019114;117.425.783.730.159
dhineshd/Bioscope;com.trioscope.chameleon&amp;G;560;1427528166;1487487316;59959150;991.388.062.169.312
yorung/BingmuWP;bingmu.pinotnoir.livewallpaper;G;571;1391885409;1468682170;76796761;126.978.771.494.709
iliakplv/notes;com.iliakplv.notes;G;572;1376235048;1455430160;79195112;130.944.298.941.799
mi9rom/achartengine;com.wsmrs.hassi;G;572;1234780750;1442577776;207797026;343.579.738.756.614
rpandey1234/Train;com.trainapp;G;575;1456444022;1490079673;33635651;556.145.023.148.148
bamptonm/RedReader;org.quantumbadger.redreader;G;582;1365084019;1432707352;67623333;111.811.066.468.254
janoliver/pOT-Droid;com.mde.potdroid;F;582;1377425830;1493635182;116209352;192.145.092.592.593
kotasunil79/AndroidIconics;com.mikepenz.iconics.sample;G;598;1414871036;1482828700;67957664;112.363.862.433.862
MemoryGroup/442repo;com.youngki.memory_project;G;605;1473376536;1481233763;7857227;129.914.467.592.593
breadwallet/breadwallet-android;com.breadwallet;G;620;1434421966;1490052807;55630841;919.822.106.481.482
codetiger/Iyan3d;com.smackall.animator;G;620;1072947713;1492058382;419110669;692.973.989.748.677
k3b/APhotoManager;com.PlayZone.quickimagegallery;G;632;1438025826;1493674440;55648614;920.115.972.222.222
Blechd0se/android_packages_apps_AeroControl;com.aero.control;F;646;1374345321;1459690820;85345499;141.113.589.616.402
Odoo-mobile/notes;com.odoo.notes;F;657;1404455912;1432804019;28348107;468.718.700.396.825
matejdro/PebbleNotificationCenter-Android;com.matejdro.pebblenotificationcenter;G;657;1385309879;1488980495;103670616;171.413.055.555.556
google/iosched;com.google.samples.apps.iosched;W;678;1342033419;1493662220;151628801;250.708.996.362.434
securityfirst/Umbrella_android;org.secfirst.umbrella;F;680;1412542502;1491814535;79272033;131.071.483.134.921
makubi/SchoolPlanner4Untis;edu.htl3r.schoolplanner;G;685;1304017343;1475499873;171482530;283.535.929.232.804
Intermodalics/tango_ros;eu.intermodalics.tango_ros_streamer;G;706;1479827867;1493975150;14147283;233.916.716.269.841
tgco/revolution-h2o;csci307.theGivingChild.CleanWaterGame;G;707;1367436217;1396781213;29344996;485.201.653.439.153
dhootha/MozuAndroidInStoreAssistant;com.mozu.mozuandroidinstoreassistant.app;G;720;1398459961;1444849801;46389840;767.027.777.777.778
Odoo-mobile/messaging;com.odoo;G;721;1377608595;1416220921;38612326;638.431.316.137.566
lgallard/qBittorrent-Controller;com.lgallardo.qbittorrentclient;G;725;1393902487;1484520560;90618073;149.831.469.907.407
Odoo-mobile/crm;com.odoo.crm;F;736;1404458210;1434540480;30082270;49.739.203.042.328
renard314/textfairy;com.renard.ocr;G;736;1369256542;1482874114;113617572;187.859.742.063.492
vx/connectbot;sk.vx.connectbot;F;739;1195278462;1383117700;187839238;310.580.750.661.376
Sefaria/Sefaria-Android;org.sefaria.sefaria&amp;G;745;1445488122;1493800221;48312099;798.811.160.714.286
wraith13/keep.grass;net.trickpalace.keep_grass;G;754;1463501402;1493889026;30387624;502.440.873.015.873
AnthonyFermin/Chip-Chop;madelyntav.c4q.nyc.chipchop;G;759;1439150178;1482650782;43500604;719.256.018.518.519
Soya93/DATX02_15_36;se.chalmers.datx02_15_36.studeraeffektivt;G;760;1422542038;1453385279;30843241;509.974.222.883.598
chrislacy/TweetLanes;com.tweetlanes.android;F;778;1360922698;1412756071;51833373;857.033.283.730.159
learnmore/gnupg-for-android;jackpal.androidterm;G;782;1324594896;1429124587;104529691;172.833.483.796.296
mamewotoko/podplayer;com.mamewo.podplayer0;G;796;1340721729;1485073199;144351470;238.676.372.354.497
WaniKani/Android-Notification;com.wanikani.androidnotifier;G;824;1368284830;1448531396;80246566;132.682.814.153.439
naoto0822/miita-android;com.naoto.yamaguchi.miita;G;836;1466518286;1486642962;20124676;332.749.272.486.773
gerc99/SawimNE;ru.sawim;F;840;1371571441;1475839754;104268313;172.401.311.177.249
marunjar/anewjkuapp;org.voidsink.anewjkuapp;F;854;1399108029;1488833562;89725533;148.355.709.325.397
GreenSkinMonster/hipda;net.jejer.hipda.ng;G;857;1424938354;1493970660;69032306;114.140.717.592.593
DownStarter/msg;org.solovyev.android.messenger;G;873;1340821564;1396862583;56041019;926.604.150.132.275
shlusiak/Freebloks-Android;de.saschahlusiak.freebloks;G;912;1334312473;1483711957;149399484;247.022.956.349.206
kimjisoo/Flym;net.fred.feedex;G;942;1366708935;1492142995;125434060;207.397.585.978.836
ebraminio/DroidPersianCalendar;com.byagowi.persiancalendar;F;945;1331291057;1488311781;157020724;259.624.212.962.963
eseidel/saycbridge;com.saycbridge.bridge;G;970;1358634990;1486220779;127585789;210.955.338.955.026
igorkraft/codestore;me.bpear.chromeapkpackager;G;983;1340639849;1492509565;151869716;251.107.334.656.085
nelenkov/wwwjdic;org.nick.wwwjdic;G;989;1267783039;1488534629;220751590;364.999.322.089.947
Cbsoftware/pressureNET;ca.cumulonimbus.barometernetwork;F;1012;1353905973;1439407697;85501724;141.371.898.148.148
nawrasg/Atlantis;fr.nawrasg.atlantis;G;1017;1437740831;1490628275;52887444;874.461.706.349.206
Exodus92/Yaaic;org.yaaic;G;1053;1242401569;1444591320;202189751;334.308.450.727.513
zulip/zulip-android;com.zulip.android;G;1057;1350328607;1493318502;142989895;236.425.090.939.153
Tribler/tribler-android;org.tribler.mobile;F;1099;1399018684;1436537158;37518474;620.345.138.888.889
LutfiTekin/RadyoMenemenPro;com.incitorrent.radyo.menemen.pro;G;1101;1464369611;1493035516;28665905;473.973.296.957.672
blurpy/kouchat-android;net.usikkert.kouchat.android;F;1136;1321383411;1472833023;151449612;250.412.718.253.968
hinnerkoetting/bumpingbunnies;de.oetting.bumpingbunnies;G;1160;1369422208;1454249692;84827484;140.257.083.333.333
kenCode-de/smartcoins-wallet;de.bitsharesmunich.smartcoinswallet;F;1218;1466263712;1492464372;26200660;433.211.970.899.471
dedyk/JaponskiPomocnik;pl.idedyk.android.japaneselearnhelper;G;1222;1338331826;1493908410;155576584;257.236.415.343.915
artiya4u/toopantip;com.duckduckgo.mobile.android&amp;G;1248;1327964759;1478080485;150115726;248.207.218.915.344
iamsergio/flow-pomodoro;com.kdab.flow_pomodoro;G;1256;1385537200;1492463693;106926493;176.796.450.066.138
BranchMetrics/android-branch-deep-linking;io.branch.branchster;G;1271;1401747439;1492027462;90280023;149.272.524.801.587
ybonnel/TransportsRennes;fr.ybo.transportsrennes;F;1282;1292279980;1491765013;199485033;329.836.364.087.302
digipost/android;no.digipost.android;G;1288;1352214999;1493018650;140803651;232.810.269.510.582
eleybourn/Book-Catalogue;com.eleybourn.bookcatalogue;F;1308;1271846851;1482414196;210567345;34.816.029.265.873
murat8505/foursquared;com.joelapenna.foursquared;G;1338;1267315238;1442517371;175202133;289.686.066.468.254
gfx/Android-Orma;com.cookpad.android.activities;G;1348;1447028788;1493360320;46331532;766.063.690.476.191
cyclestreets/android;net.cyclestreets;G;1419;1281362250;1493059797;211697547;350.029.012.896.825
PaperAirplane-Dev-Team/BlackLight;us.shandian.blacklight;G;1439;1399046163;1467957082;68910919;113.940.011.574.074
Claydot/AVARELOG;com.ds.avare&amp;G;1459;1402226909;1479821816;77594907;12.829.845.734.127
sunlightlabs/congress-android;com.sunlightlabs.android.congress;G;1494;1250099413;1400272439;150173026;248.301.960.978.836
murraycu/android-galaxyzoo;com.murrayc.galaxyzoo.app;W;1501;1404303542;1492696263;88392721;146.151.985.780.423
Yooii-Studios/News-Kit;com.yooiistudios.newskit;G;1508;1407739311;1486351298;78611987;12.998.013.723.545
spacecowboy/NotePad;com.nononsenseapps.notepad;F;1521;1326449859;1486162440;159712581;264.075.034.722.222
makings/mst;org.qii.weiciyuan;G;1581;1343312584;1357972011;14659427;242.384.705.687.831
HSAnet/glimpse_client;net.measureit.glimpse;G;1593;1363534341;1449670861;86136520;142.421.494.708.995
sampalmer/android-auto-rotate;samuelpalmer.sensorautorotation;G;1596;1421743300;1493969835;72226535;119.422.180.886.243
Kazade/simulant-engine;uk.co.kazade.rocks;G;1599;1323684278;1493237912;169553634;280.346.617.063.492
hidroh/materialistic;iohub.hidroh.materialistic;F;1603;1421899434;1493548805;71649371;118.467.875.330.688
vogtp/android-CPU-tuner;ch.amana.android.cputuner;F;1676;1288723141;1387397155;98674014;163.151.478.174.603
mercury199/PixelDungRemix;com.nyrds.pixeldungeon.ml;G;1737;1406469445;1461540918;55071473;910.573.296.957.672
reicast/reicast-emulator;com.reicast.emulator;F;1752;1387473014;1483184822;95711808;158.253.650.793.651
charlesmadere/that-lil-hummingbird;com.charlesmadere.hummingbird;G;1776;1460508504;1480288864;19780360;327.056.216.931.217
arpitkh96/AmazeFileManager;com.amaze.filemanager;F;1842;1446986349;1493991693;47005344;777.204.761.904.762
Neamar/KISS;fr.neamar.kiss;F;1846;1349184510;1493430994;144246484;238.502.784.391.534
uholeschak/ediabaslib;de.holeschak.bmw_deep_obd;G;1866;1410859974;1493754858;82894884;137.061.646.825.397
De7vID/klingon-assistant;org.tlhInganHol.android.klingonassistant;G;1909;1347565699;1493628354;146062655;241.505.712.632.275
NicoAdams/ShatteredPixelDungeon;com.shatteredpixel.shatteredpixeldungeon;G;1945;1406396072;1478473182;72077110;119.175.115.740.741
sozialhelden/wheelmap-android;org.wheelmap.android.online;F;2008;1309374756;1492516416;183141660;302.813.591.269.841
OneBusAway/onebusaway-android;com.joulespersecond.seattlebusbot;F;2009;1248922788;1493835665;244912877;404.948.540.013.228
surespot/android;com.twofours.surespot;W;2121;1367802342;1490194533;122392191;202.368.040.674.603
BansheeMediaPlayer/banshee-community-extensions;org.nstamato.bansheeremote;F;2136;1265292292;1433842590;168550298;278.687.662.037.037
serso/android-calculatorpp;org.solovyev.android.calculator;F;2153;1308863353;1471170965;162307612;268.365.760.582.011
almalence/OpenCamera;com.almalence.opencam;F;2211;1381832487;1492669809;110837322;183.262.767.857.143
PeishengYE/NetGuardAPI23;eu.faircode.netguard;G;2237;1445709560;1466621522;20911962;345.766.567.460.317
btmura/rbb;com.btmura.android.reddit;F;2347;1326596003;1437965783;111369780;184.143.154.761.905
iFixit/iFixitAndroid;com.dozuki.ifixit;W;2479;1315107597;1490747917;175640320;290.410.582.010.582
Groestlcoin/groestlcoin-wallet;hashengineering.groestlcoin.wallet;F;2525;1299574237;1490769106;191194869;31.612.908.234.127
OpenSilk/Orpheus;org.opensilk.music;F;2577;1325779498;1453258705;127479207;210.779.112.103.175
Yooii-Studios/morning-kit-android;com.yooiistudios.morningkit;G;2692;1382194356;1486351353;104156997;172.217.256.944.444
pelya/commandergenius;x.org.server;F;2769;1244316295;1491941837;247625542;409.433.766.534.392
WhisperSystems/Signal-Android;org.thoughtcrime.securesms&amp;W;2906;1324405244;1493573371;169168127;279.709.204.695.767
chrisboyle/sgtpuzzles;name.boyle.chris.sgtpuzzles;F;3246;1082903278;1482655709;399752431;660.966.321.097.884
ccrama/Slide;me.ccrama.redditslide;F;3298;1443741747;1493920355;50178608;829.672.751.322.751
popeen/Popeens-DSub;github.popeen.dsub;G;3848;1341288739;1485728954;144440215;238.823.106.812.169
siacs/Conversations;eu.siacs.conversations&amp;W;4129;1413995924;1493928706;79932782;132.163.991.402.116
wikimedia/apps-android-wikipedia;org.wikipedia;F;5215;1382711581;1493909925;111198344;183.859.695.767.196
owncloud/android;com.owncloud.android;W;5850;1313786255;1493939623;180153368;297.872.632.275.132
open-keychain/open-keychain;org.sufficientlysecure.keychain;W;6149;1269818107;1493703672;223885565;370.181.159.060.847
k9mail/k-9;com.fsck.k9;W;7168;1229468262;1493691704;264223442;436.877.384.259.259
nextcloud/android;com.nextcloud.client;F;7248;1313786255;1493943690;180157435;297.879.356.812.169
UweTrottmann/SeriesGuide;com.battlelancer.seriesguide;F;8164;1309689081;1493387119;183698038;303.733.528.439.153
actorapp/actor-platform;im.actor.cloud;F;8308;1423285193;1480848246;57563053;951.770.056.216.931
matuszuborupc/mzgeo;cgeo.geocaching;G;9809;1315316138;1471276947;155960809;257.871.708.002.646
freeminer/freeminer;org.freeminer.freeminer;G;10846;1385503591;1493487928;107984337;178.545.530.753.968
samuelclay/NewsBlur;com.newsblur;F;11650;1245115098;1493665736;248550638;410.963.356.481.481
wordpress-mobile/WordPress-Android;org.wordpress.android;W;21313;1457099967;1493934361;36834394;609.034.292.328.042
mapsme/omim;com.mapswithme.maps.pro;W;23271;1442950437;1493895812;50945375;842.350.777.116.402
osmandapp/Osmand;net.osmand;W;38339;1272232963;1493919541;221686578;366.545.267.857.143
